dtto,municipio,secc,PAN_UDC,PRI_PVEM_PNA_PPC,PRI_PNA_PSD,PRI_PNA_PPC,PRI,PRD,PT,PVEM,CONV,PNA,PSDC,PPC,CC1,VALIDOS,NULOS,TOTAL
13,ABASOLO,1,149,0,0,0,343,2,2,1,1,1,1,0,2,502,10,512
13,ABASOLO,2,118,0,0,0,122,0,0,2,3,0,3,0,0,248,4,252
15,ACUÑA,3,270,0,0,0,1073,9,11,14,8,10,12,28,4,1439,38,1477
15,ACUÑA,4,609,0,0,0,2152,29,31,22,6,8,21,11,11,2900,61,2961
15,ACUÑA,5,221,0,0,0,640,12,7,12,2,5,5,14,5,923,18,941
15,ACUÑA,6,119,0,0,0,374,11,9,2,0,3,4,2,2,526,12,538
15,ACUÑA,7,163,0,0,0,493,8,10,4,2,5,5,3,5,698,16,714
15,ACUÑA,8,154,0,0,0,515,4,6,3,3,5,5,4,1,700,17,717
15,ACUÑA,9,1601,0,0,0,4951,49,72,44,31,38,76,84,15,6961,129,7090
15,ACUÑA,10,1632,0,0,0,4600,60,42,32,20,24,63,66,55,6594,115,6709
15,ACUÑA,11,322,0,0,0,1121,9,11,11,2,8,14,12,9,1519,32,1551
15,ACUÑA,12,359,0,0,0,1276,19,18,9,5,18,22,29,8,1763,41,1804
15,ACUÑA,13,74,0,0,0,211,2,5,1,0,1,4,1,1,300,4,304
15,ACUÑA,14,88,0,0,0,360,6,6,2,0,4,2,2,2,472,8,480
15,ACUÑA,15,118,0,0,0,378,4,7,3,1,4,5,1,8,529,13,542
15,ACUÑA,16,142,0,0,0,325,4,2,2,2,1,5,3,0,486,13,499
15,ACUÑA,17,141,0,0,0,309,5,8,4,1,7,5,1,3,484,6,490
15,ACUÑA,18,240,0,0,0,737,21,13,8,3,9,9,2,5,1047,36,1083
15,ACUÑA,19,1356,0,0,0,3387,31,55,26,38,34,36,66,14,5043,97,5140
15,ACUÑA,20,163,0,0,0,420,12,7,3,1,9,3,4,7,629,6,635
15,ACUÑA,21,186,0,0,0,432,1,5,7,1,6,2,0,0,640,17,657
15,ACUÑA,22,111,0,0,0,346,4,17,3,0,2,5,5,6,499,15,514
15,ACUÑA,23,85,0,0,0,221,5,4,3,3,4,6,4,0,335,6,341
15,ACUÑA,24,78,0,0,0,264,2,8,4,2,1,4,5,2,370,8,378
15,ACUÑA,25,211,0,0,0,449,6,8,5,2,15,12,5,1,714,13,727
15,ACUÑA,26,137,0,0,0,301,3,11,3,1,7,7,3,3,476,13,489
15,ACUÑA,27,130,0,0,0,352,5,3,5,2,9,0,2,4,512,11,523
15,ACUÑA,28,185,0,0,0,593,4,10,6,5,1,11,7,7,829,18,847
15,ACUÑA,29,203,0,0,0,757,5,11,7,3,7,9,8,2,1012,26,1038
15,ACUÑA,30,231,0,0,0,483,10,14,5,8,14,3,8,2,778,11,789
15,ACUÑA,31,777,0,0,0,2216,28,37,29,14,53,30,48,18,3250,60,3310
15,ACUÑA,32,79,0,0,0,415,2,9,4,2,8,3,3,3,528,8,536
15,ACUÑA,33,583,0,0,0,1608,24,15,18,10,19,31,43,14,2365,50,2415
15,ACUÑA,34,625,0,0,0,1755,10,30,14,6,16,34,23,8,2521,68,2589
15,ACUÑA,35,483,0,0,0,1559,16,31,19,8,14,19,24,18,2191,63,2254
15,ACUÑA,36,176,0,0,0,589,9,9,2,2,2,3,6,5,803,31,834
15,ACUÑA,37,131,0,0,0,535,7,7,4,2,3,4,3,1,697,26,723
15,ACUÑA,40,2,0,0,0,6,0,0,0,0,0,0,0,0,8,1,9
15,ACUÑA,41,375,0,0,0,1257,15,12,18,8,4,10,10,9,1718,44,1762
14,ALLENDE,42,451,0,677,0,0,14,21,7,4,0,0,0,0,1174,16,1190
14,ALLENDE,43,348,0,525,0,0,9,12,10,2,0,0,0,0,906,25,931
14,ALLENDE,44,308,0,359,0,0,3,7,5,2,0,0,0,0,684,16,700
14,ALLENDE,45,188,0,262,0,0,6,4,3,1,0,0,0,0,464,16,480
14,ALLENDE,46,244,0,316,0,0,8,6,4,6,0,0,0,0,584,21,605
14,ALLENDE,47,385,0,521,0,0,16,10,11,3,0,0,0,0,946,23,969
14,ALLENDE,48,166,0,289,0,0,12,3,3,3,0,0,0,0,476,17,493
14,ALLENDE,49,247,0,437,0,0,9,2,7,3,0,0,0,0,705,27,732
14,ALLENDE,50,318,0,365,0,0,5,4,5,2,0,0,0,0,699,26,725
14,ALLENDE,51,416,0,569,0,0,10,6,9,6,0,0,0,0,1016,33,1049
14,ALLENDE,52,171,0,252,0,0,4,7,4,1,0,0,0,0,439,17,456
14,ALLENDE,53,182,0,302,0,0,8,4,5,2,0,0,0,0,503,18,521
14,ALLENDE,54,357,0,455,0,0,3,4,4,4,0,0,0,0,827,19,846
14,ALLENDE,55,228,0,613,0,0,8,12,4,5,0,0,0,0,870,30,900
14,ALLENDE,56,28,0,64,0,0,1,0,0,0,0,0,0,0,93,9,102
5,ARTEAGA,57,577,1422,0,0,0,34,17,0,12,0,7,0,0,2069,93,2162
5,ARTEAGA,58,108,270,0,0,0,4,4,0,2,0,1,0,0,389,10,399
5,ARTEAGA,59,344,645,0,0,0,18,11,0,7,0,3,0,0,1028,36,1064
5,ARTEAGA,60,6,33,0,0,0,1,1,0,0,0,0,0,0,41,0,41
5,ARTEAGA,61,15,87,0,0,0,2,0,0,0,0,0,0,0,104,4,108
5,ARTEAGA,62,11,45,0,0,0,0,2,0,0,0,0,0,0,58,4,62
5,ARTEAGA,63,185,407,0,0,0,11,13,0,7,0,2,0,0,625,22,647
5,ARTEAGA,64,142,570,0,0,0,6,6,0,4,0,15,0,0,743,37,780
5,ARTEAGA,65,6,28,0,0,0,1,0,0,0,0,1,0,0,36,5,41
5,ARTEAGA,66,119,222,0,0,0,3,4,0,0,0,6,0,0,354,28,382
5,ARTEAGA,67,41,66,0,0,0,0,5,0,0,0,1,0,0,113,5,118
5,ARTEAGA,68,25,145,0,0,0,1,1,0,3,0,3,0,0,178,14,192
5,ARTEAGA,69,105,593,0,0,0,2,10,0,3,0,4,0,0,717,41,758
5,ARTEAGA,70,56,252,0,0,0,0,2,0,4,0,4,0,0,318,15,333
5,ARTEAGA,71,20,117,0,0,0,0,1,0,0,0,0,0,0,138,1,139
5,ARTEAGA,72,27,84,0,0,0,0,3,0,0,0,2,0,0,116,2,118
5,ARTEAGA,73,70,110,0,0,0,2,3,0,1,0,2,0,0,188,8,196
5,ARTEAGA,74,82,229,0,0,0,3,6,0,1,0,2,0,0,323,23,346
5,ARTEAGA,75,338,1009,0,0,0,4,13,0,5,0,10,0,0,1379,38,1417
5,ARTEAGA,76,35,89,0,0,0,0,1,0,0,0,8,0,0,133,3,136
5,ARTEAGA,77,24,93,0,0,0,1,1,0,0,0,0,0,0,119,6,125
5,ARTEAGA,78,99,402,0,0,0,0,7,0,6,0,4,0,0,518,25,543
5,ARTEAGA,79,210,765,0,0,0,6,8,0,3,0,1,0,0,993,62,1055
5,ARTEAGA,80,83,288,0,0,0,2,5,0,6,0,7,0,0,391,9,400
12,CANDELA,81,92,0,218,0,0,7,3,1,0,0,0,0,0,321,9,330
12,CANDELA,82,222,0,407,0,0,4,4,9,3,0,0,0,0,649,17,666
12,CANDELA,83,18,0,184,0,0,0,0,1,1,0,0,0,0,204,7,211
12,CASTAÑOS,84,299,0,645,0,0,54,24,10,65,0,0,0,0,1097,27,1124
12,CASTAÑOS,85,143,0,336,0,0,16,16,5,27,0,0,0,0,543,16,559
12,CASTAÑOS,86,157,0,387,0,0,52,15,8,12,0,0,0,0,631,34,665
12,CASTAÑOS,87,274,0,666,0,0,56,39,5,53,0,0,0,0,1093,27,1120
12,CASTAÑOS,88,170,0,484,0,0,15,23,6,40,0,0,0,0,738,25,763
12,CASTAÑOS,89,246,0,594,0,0,39,21,7,45,0,0,0,0,952,22,974
12,CASTAÑOS,90,314,0,463,0,0,21,13,3,35,0,0,0,0,849,20,869
12,CASTAÑOS,91,189,0,460,0,0,29,22,5,51,0,0,0,0,756,14,770
12,CASTAÑOS,92,153,0,341,0,0,21,7,9,23,0,0,0,0,554,32,586
12,CASTAÑOS,93,92,0,357,0,0,15,18,2,19,0,0,0,0,503,59,562
12,CASTAÑOS,94,312,0,454,0,0,30,31,5,33,0,0,0,0,865,17,882
12,CASTAÑOS,96,297,0,553,0,0,44,10,7,41,0,0,0,0,952,34,986
12,CASTAÑOS,97,69,0,168,0,0,17,2,3,3,0,0,0,0,262,7,269
12,CASTAÑOS,98,64,0,63,0,0,4,2,0,0,0,0,0,0,133,1,134
12,CASTAÑOS,99,8,0,60,0,0,3,2,0,0,0,0,0,0,73,1,74
12,CASTAÑOS,101,6,0,35,0,0,2,2,0,1,0,0,0,0,46,3,49
12,CASTAÑOS,102,11,0,84,0,0,1,0,1,4,0,0,0,0,101,0,101
12,CASTAÑOS,103,8,0,33,0,0,2,1,0,0,0,0,0,0,44,1,45
12,CASTAÑOS,104,17,0,142,0,0,5,3,0,1,0,0,0,0,168,6,174
12,CASTAÑOS,105,7,0,113,0,0,3,0,0,0,0,0,0,0,123,4,127
12,CASTAÑOS,106,15,0,128,0,0,2,0,0,1,0,0,0,0,146,1,147
12,CASTAÑOS,107,1,0,2,0,0,1,0,0,0,0,0,0,0,4,5,9
12,CASTAÑOS,108,2,0,163,0,0,0,0,1,0,0,0,0,0,166,4,170
12,CASTAÑOS,109,18,0,78,0,0,3,4,1,0,0,0,0,0,104,4,108
11,CUATROCIENEGAS,110,133,0,0,154,0,6,5,2,6,0,1,0,0,307,16,323
11,CUATROCIENEGAS,111,284,0,0,302,0,10,3,4,20,0,2,0,0,625,11,636
11,CUATROCIENEGAS,112,143,0,0,266,0,9,1,3,8,0,1,0,0,431,2,433
11,CUATROCIENEGAS,113,368,0,0,441,0,17,8,3,16,0,3,0,0,856,16,872
11,CUATROCIENEGAS,114,220,0,0,305,0,5,6,3,14,0,6,0,0,559,15,574
11,CUATROCIENEGAS,115,252,0,0,277,0,5,8,3,12,0,4,0,0,561,18,579
11,CUATROCIENEGAS,116,615,0,0,548,0,17,8,6,21,0,2,0,0,1217,35,1252
11,CUATROCIENEGAS,117,10,0,0,21,0,1,1,0,0,0,0,0,0,33,0,33
11,CUATROCIENEGAS,118,17,0,0,42,0,0,0,0,0,0,0,0,0,59,5,64
11,CUATROCIENEGAS,119,38,0,0,44,0,3,0,0,1,0,2,0,0,88,7,95
11,CUATROCIENEGAS,121,13,0,0,92,0,2,1,0,0,0,0,0,0,108,1,109
11,CUATROCIENEGAS,122,60,0,0,118,0,2,2,0,2,0,0,0,0,184,3,187
11,CUATROCIENEGAS,123,165,0,0,170,0,6,7,2,2,0,0,0,0,352,10,362
11,CUATROCIENEGAS,124,32,0,0,121,0,2,1,0,0,0,0,0,0,156,7,163
11,CUATROCIENEGAS,125,80,0,0,40,0,1,0,2,1,0,0,0,0,124,0,124
11,CUATROCIENEGAS,126,37,0,0,205,0,0,0,0,2,0,0,0,0,244,10,254
13,ESCOBEDO,127,34,0,0,0,119,3,0,1,0,0,0,1,1,159,4,163
13,ESCOBEDO,128,31,0,0,0,103,2,1,3,0,0,0,3,0,143,3,146
13,ESCOBEDO,129,70,0,0,0,140,0,1,0,0,0,0,0,0,211,9,220
13,ESCOBEDO,130,311,0,0,0,672,4,9,4,8,0,2,1,2,1013,30,1043
10,FRANCISCO I. MADERO,131,284,0,0,0,802,14,35,134,29,6,5,2,8,1319,32,1351
10,FRANCISCO I. MADERO,132,231,0,0,0,415,10,61,79,0,9,1,11,4,821,25,846
10,FRANCISCO I. MADERO,133,110,0,0,0,363,6,15,10,2,3,0,7,11,527,16,543
10,FRANCISCO I. MADERO,134,308,0,0,0,680,32,59,45,9,9,4,50,3,1199,24,1223
10,FRANCISCO I. MADERO,135,184,0,0,0,626,14,36,22,3,24,3,50,5,967,26,993
10,FRANCISCO I. MADERO,136,152,0,0,0,400,12,20,13,1,19,5,32,4,658,12,670
10,FRANCISCO I. MADERO,137,172,0,0,0,377,4,13,24,0,3,3,15,0,611,23,634
10,FRANCISCO I. MADERO,138,193,0,0,0,512,14,16,21,2,17,8,36,0,819,20,839
10,FRANCISCO I. MADERO,139,155,0,0,0,382,11,24,15,1,9,7,21,1,626,14,640
10,FRANCISCO I. MADERO,140,119,0,0,0,0,2,23,5,7,2,2,15,1,176,3,179
10,FRANCISCO I. MADERO,141,147,0,0,0,383,8,18,7,7,8,3,11,1,593,13,606
10,FRANCISCO I. MADERO,142,190,0,0,0,282,12,34,8,4,16,2,29,0,577,13,590
10,FRANCISCO I. MADERO,143,232,0,0,0,544,16,21,10,6,12,4,47,1,893,17,910
10,FRANCISCO I. MADERO,144,189,0,0,0,515,11,21,13,2,7,0,20,2,780,18,798
10,FRANCISCO I. MADERO,145,205,0,0,0,470,12,22,36,1,4,2,18,1,771,25,796
10,FRANCISCO I. MADERO,146,194,0,0,0,611,146,34,65,5,28,0,6,1,1090,32,1122
10,FRANCISCO I. MADERO,147,273,0,0,0,645,23,37,16,3,12,3,44,7,1063,24,1087
10,FRANCISCO I. MADERO,148,271,0,0,0,339,13,31,22,2,4,3,14,1,700,17,717
10,FRANCISCO I. MADERO,149,47,0,0,0,73,0,1,1,1,1,0,0,1,125,3,128
10,FRANCISCO I. MADERO,150,148,0,0,0,142,8,3,6,1,0,1,1,0,310,6,316
10,FRANCISCO I. MADERO,151,46,0,0,0,48,2,4,2,1,0,0,0,0,103,2,105
10,FRANCISCO I. MADERO,152,120,0,0,0,326,6,7,5,2,3,0,1,0,470,5,475
10,FRANCISCO I. MADERO,153,136,0,0,0,183,11,9,3,4,8,3,2,2,361,12,373
10,FRANCISCO I. MADERO,154,132,0,0,0,322,2,6,4,1,2,2,4,0,475,12,487
10,FRANCISCO I. MADERO,155,73,0,0,0,157,5,19,1,1,1,1,3,0,261,4,265
10,FRANCISCO I. MADERO,156,97,0,0,0,227,3,5,59,2,7,1,7,1,409,8,417
10,FRANCISCO I. MADERO,157,229,0,0,0,375,24,18,12,1,7,1,3,0,670,6,676
10,FRANCISCO I. MADERO,158,57,0,0,0,257,2,14,59,2,0,1,19,2,413,11,424
10,FRANCISCO I. MADERO,159,167,0,0,0,387,9,39,16,3,5,2,5,0,633,15,648
10,FRANCISCO I. MADERO,160,92,0,0,0,184,8,29,14,2,4,0,3,0,336,15,351
10,FRANCISCO I. MADERO,161,148,0,0,0,236,53,20,23,1,6,2,4,4,497,8,505
10,FRANCISCO I. MADERO,162,136,0,0,0,312,37,337,17,6,13,21,1,3,883,57,940
10,FRANCISCO I. MADERO,163,203,0,0,0,186,7,21,2,1,5,1,0,0,426,11,437
10,FRANCISCO I. MADERO,164,150,0,0,0,194,2,7,4,2,4,1,3,0,367,4,371
10,FRANCISCO I. MADERO,165,157,0,0,0,239,8,9,33,0,1,3,6,0,456,12,468
10,FRANCISCO I. MADERO,166,161,0,0,0,286,4,11,14,3,19,1,2,1,502,12,514
10,FRANCISCO I. MADERO,167,40,0,0,0,87,6,17,57,0,3,0,5,2,217,1,218
10,FRANCISCO I. MADERO,168,174,0,0,0,561,13,13,34,1,20,1,0,0,817,17,834
10,FRANCISCO I. MADERO,169,259,0,0,0,549,16,23,84,7,6,1,18,4,967,18,985
10,FRANCISCO I. MADERO,170,61,0,0,0,187,3,5,71,1,2,1,1,0,332,5,337
10,FRANCISCO I. MADERO,171,285,0,0,0,397,6,3,54,1,5,1,5,1,758,9,767
10,FRANCISCO I. MADERO,172,188,0,0,0,233,7,4,11,2,1,0,1,1,448,14,462
11,FRONTERA,173,685,0,0,790,0,29,32,25,29,0,15,0,0,1605,56,1661
11,FRONTERA,174,639,0,0,987,0,42,43,23,30,0,8,0,0,1772,64,1836
11,FRONTERA,175,539,0,0,837,0,19,44,20,15,0,1,0,0,1475,39,1514
11,FRONTERA,176,346,0,0,547,0,17,25,13,5,0,11,0,0,964,15,979
11,FRONTERA,177,366,0,0,539,0,14,19,4,12,0,11,0,0,965,23,988
11,FRONTERA,178,302,0,0,549,0,20,17,2,7,0,4,0,0,901,13,914
11,FRONTERA,179,290,0,0,407,0,14,22,8,21,0,4,0,0,766,27,793
11,FRONTERA,180,273,0,0,460,0,11,16,12,8,0,3,0,0,783,23,806
11,FRONTERA,181,277,0,0,314,0,13,18,7,5,0,3,0,0,637,10,647
11,FRONTERA,182,207,0,0,286,0,18,7,2,11,0,1,0,0,532,18,550
11,FRONTERA,183,268,0,0,359,0,14,24,7,10,0,5,0,0,687,24,711
11,FRONTERA,184,258,0,0,358,0,7,10,4,12,0,1,0,0,650,14,664
11,FRONTERA,185,445,0,0,412,0,19,25,10,7,0,3,0,0,921,25,946
11,FRONTERA,186,282,0,0,270,0,23,12,6,4,0,6,0,0,603,6,609
11,FRONTERA,187,386,0,0,385,0,21,28,15,12,0,10,0,0,857,22,879
11,FRONTERA,188,303,0,0,362,0,18,39,3,12,0,1,0,0,738,27,765
11,FRONTERA,189,214,0,0,277,0,6,11,3,4,0,2,0,0,517,19,536
11,FRONTERA,190,282,0,0,281,0,13,12,3,15,0,5,0,0,611,17,628
11,FRONTERA,191,289,0,0,502,0,4,13,8,6,0,3,0,0,825,23,848
11,FRONTERA,192,376,0,0,618,0,8,16,10,8,0,5,0,0,1041,24,1065
11,FRONTERA,193,396,0,0,461,0,11,14,7,10,0,2,0,0,901,20,921
11,FRONTERA,194,172,0,0,219,0,7,7,1,5,0,1,0,0,412,27,439
11,FRONTERA,195,338,0,0,301,0,15,23,8,13,0,3,0,0,701,18,719
11,FRONTERA,196,207,0,0,255,0,8,10,15,19,0,5,0,0,519,13,532
11,FRONTERA,197,306,0,0,357,0,24,16,10,13,0,3,0,0,729,232,961
11,FRONTERA,198,354,0,0,491,0,12,10,5,7,0,3,0,0,882,21,903
11,FRONTERA,199,291,0,0,476,0,7,8,11,15,0,7,0,0,815,21,836
11,FRONTERA,200,323,0,0,454,0,10,18,9,31,0,0,0,0,845,21,866
11,FRONTERA,201,197,0,0,289,0,10,12,6,9,0,0,0,0,523,178,701
11,FRONTERA,202,253,0,0,409,0,11,5,5,46,0,1,0,0,730,16,746
11,FRONTERA,203,238,0,0,331,0,5,6,11,42,0,3,0,0,636,20,656
11,FRONTERA,204,267,0,0,428,0,3,4,12,11,0,2,0,0,727,16,743
11,FRONTERA,205,136,0,0,235,0,12,6,2,30,0,1,0,0,422,17,439
11,FRONTERA,206,262,0,0,411,0,7,11,9,15,0,1,0,0,716,16,732
11,FRONTERA,207,281,0,0,505,0,7,18,7,18,0,1,0,0,837,20,857
11,FRONTERA,208,264,0,0,551,0,11,18,5,18,0,6,0,0,873,28,901
11,FRONTERA,209,399,0,0,459,0,4,10,6,9,0,3,0,0,890,19,909
11,FRONTERA,210,279,0,0,456,0,7,12,8,10,0,3,0,0,775,32,807
11,FRONTERA,211,465,0,0,463,0,5,15,9,1,0,0,0,0,958,27,985
11,FRONTERA,212,327,0,0,463,0,2,14,5,2,0,0,0,0,813,17,830
11,FRONTERA,213,56,0,0,75,0,0,1,0,2,0,3,0,0,137,0,137
5,GENERAL CEPEDA,214,379,458,0,0,0,2,7,0,2,0,2,0,0,850,24,874
5,GENERAL CEPEDA,215,222,312,0,0,0,5,4,0,4,0,1,0,0,548,11,559
5,GENERAL CEPEDA,216,391,444,0,0,0,10,5,0,7,0,0,0,0,857,20,877
5,GENERAL CEPEDA,217,164,158,0,0,0,4,10,0,3,0,3,0,0,342,22,364
5,GENERAL CEPEDA,218,95,148,0,0,0,1,7,0,1,0,2,0,0,254,4,258
5,GENERAL CEPEDA,219,22,53,0,0,0,2,7,0,0,0,1,0,0,85,4,89
5,GENERAL CEPEDA,220,104,131,0,0,0,6,5,0,1,0,1,0,0,248,8,256
5,GENERAL CEPEDA,221,18,43,0,0,0,0,1,0,0,0,1,0,0,63,0,63
5,GENERAL CEPEDA,222,114,235,0,0,0,5,6,0,3,0,1,0,0,364,19,383
5,GENERAL CEPEDA,223,118,141,0,0,0,1,7,0,9,0,0,0,0,276,15,291
5,GENERAL CEPEDA,224,9,40,0,0,0,0,0,0,0,0,0,0,0,49,0,49
5,GENERAL CEPEDA,225,178,121,0,0,0,1,3,0,1,0,1,0,0,305,13,318
5,GENERAL CEPEDA,226,130,107,0,0,0,0,1,0,2,0,2,0,0,242,4,246
5,GENERAL CEPEDA,227,103,85,0,0,0,2,4,0,1,0,3,0,0,198,10,208
5,GENERAL CEPEDA,228,71,144,0,0,0,1,4,0,4,0,0,0,0,224,13,237
5,GENERAL CEPEDA,229,105,144,0,0,0,1,6,0,3,0,1,0,0,260,15,275
5,GENERAL CEPEDA,230,89,84,0,0,0,2,5,0,2,0,3,0,0,185,10,195
5,GENERAL CEPEDA,231,163,199,0,0,0,5,9,0,7,0,3,0,0,386,19,405
14,GUERRERO,233,70,0,265,0,0,0,1,1,1,0,0,0,0,338,11,349
14,GUERRERO,234,33,0,198,0,0,2,3,1,0,0,0,0,0,237,6,243
14,GUERRERO,235,25,0,144,0,0,2,0,0,1,0,0,0,0,172,3,175
14,GUERRERO,236,84,0,151,0,0,2,7,3,3,0,0,0,0,250,9,259
14,GUERRERO,237,52,0,108,0,0,1,4,0,4,0,0,0,0,169,2,171
14,HIDALGO,238,9,0,177,0,0,1,0,1,0,0,0,0,0,188,3,191
14,HIDALGO,239,47,0,491,0,0,1,1,1,0,0,0,0,0,541,2,543
15,JIMENEZ,240,25,0,0,0,205,3,1,4,1,1,0,2,5,247,12,259
15,JIMENEZ,241,25,0,0,0,305,2,3,6,0,0,2,0,0,343,7,350
15,JIMENEZ,242,159,0,0,0,752,6,5,8,3,0,1,3,0,937,29,966
15,JIMENEZ,243,165,0,0,0,354,9,9,1,2,2,1,10,40,593,14,607
15,JIMENEZ,244,93,0,0,0,321,2,5,5,2,0,2,9,0,439,17,456
15,JIMENEZ,245,281,0,0,0,670,11,8,4,0,5,2,4,29,1014,35,1049
15,JIMENEZ,246,316,0,0,0,467,20,7,3,1,2,4,2,1,823,30,853
15,JIMENEZ,247,36,0,0,0,39,2,0,0,1,0,0,1,1,80,1,81
15,JIMENEZ,248,10,0,0,0,131,1,1,0,1,0,0,1,1,146,3,149
15,JIMENEZ,249,92,0,0,0,331,5,5,5,1,1,3,3,0,446,20,466
14,JUAREZ,250,152,0,195,0,0,6,3,7,2,0,0,0,0,365,5,370
14,JUAREZ,251,89,0,112,0,0,4,2,9,0,0,0,0,0,216,1,217
14,JUAREZ,252,121,0,130,0,0,5,5,2,1,0,0,0,0,264,6,270
14,JUAREZ,253,23,0,45,0,0,2,0,3,1,0,0,0,0,74,3,77
14,JUAREZ,254,33,0,67,0,0,4,2,0,1,0,0,0,0,107,5,112
11,LAMADRID,255,271,0,0,260,0,3,12,4,6,0,2,0,0,558,19,577
11,LAMADRID,256,300,0,0,373,0,6,2,4,10,0,0,0,0,695,15,710
6,MATAMOROS,257,237,0,413,0,0,18,13,13,7,0,0,75,0,776,28,804
6,MATAMOROS,258,202,0,713,0,0,12,32,25,7,0,0,164,0,1155,32,1187
6,MATAMOROS,259,247,0,513,0,0,12,26,14,15,0,0,131,0,958,38,996
6,MATAMOROS,260,324,0,658,0,0,11,23,26,9,0,0,199,0,1250,33,1283
6,MATAMOROS,261,236,0,444,0,0,10,27,21,5,0,0,154,0,897,35,932
6,MATAMOROS,262,264,0,501,0,0,13,34,21,13,0,0,130,0,976,22,998
6,MATAMOROS,263,244,0,378,0,0,10,16,14,12,0,0,146,0,820,29,849
6,MATAMOROS,264,230,0,447,0,0,10,24,13,9,0,0,179,0,912,21,933
6,MATAMOROS,265,470,0,972,0,0,20,43,41,28,0,0,297,0,1871,45,1916
6,MATAMOROS,266,152,0,454,0,0,8,22,11,11,0,0,168,0,826,14,840
6,MATAMOROS,267,125,0,357,0,0,6,19,12,6,0,0,149,0,674,20,694
6,MATAMOROS,268,330,0,609,0,0,13,40,30,14,0,0,139,0,1175,40,1215
6,MATAMOROS,269,531,0,834,0,0,17,57,27,22,0,0,251,0,1739,57,1796
6,MATAMOROS,270,175,0,284,0,0,4,22,5,4,0,0,77,0,571,15,586
6,MATAMOROS,271,195,0,530,0,0,9,36,13,11,0,0,321,0,1115,36,1151
6,MATAMOROS,272,286,0,424,0,0,5,16,8,10,0,0,355,0,1104,47,1151
6,MATAMOROS,273,224,0,383,0,0,12,22,12,5,0,0,91,0,749,25,774
6,MATAMOROS,274,248,0,498,0,0,7,23,17,8,0,0,230,0,1031,52,1083
6,MATAMOROS,275,266,0,398,0,0,4,19,9,8,0,0,86,0,790,22,812
6,MATAMOROS,276,186,0,392,0,0,4,30,28,8,0,0,205,0,853,33,886
6,MATAMOROS,277,139,0,305,0,0,10,2,12,2,0,0,85,0,555,19,574
6,MATAMOROS,278,93,0,326,0,0,7,5,3,2,0,0,34,0,470,17,487
6,MATAMOROS,279,74,0,474,0,0,9,3,6,1,0,0,23,0,590,9,599
6,MATAMOROS,280,342,0,695,0,0,13,13,6,4,0,0,88,0,1161,51,1212
6,MATAMOROS,281,104,0,213,0,0,1,0,1,0,0,0,44,0,363,18,381
6,MATAMOROS,282,309,0,314,0,0,59,6,5,3,0,0,38,0,734,7,741
6,MATAMOROS,283,241,0,363,0,0,10,12,7,3,0,0,119,0,755,22,777
6,MATAMOROS,284,145,0,509,0,0,7,6,3,12,0,0,317,0,999,29,1028
6,MATAMOROS,285,107,0,461,0,0,6,8,5,6,0,0,184,0,777,23,800
6,MATAMOROS,286,129,0,485,0,0,8,8,4,12,0,0,268,0,914,20,934
6,MATAMOROS,287,89,0,555,0,0,7,9,7,4,0,0,374,0,1045,26,1071
6,MATAMOROS,288,205,0,660,0,0,12,9,4,9,0,0,317,0,1216,27,1243
6,MATAMOROS,289,205,0,360,0,0,14,8,4,5,0,0,17,0,613,16,629
6,MATAMOROS,290,321,0,538,0,0,16,16,3,7,0,0,177,0,1078,28,1106
6,MATAMOROS,291,202,0,754,0,0,11,4,3,7,0,0,58,0,1039,13,1052
6,MATAMOROS,292,173,0,289,0,0,5,3,3,3,0,0,50,0,526,11,537
6,MATAMOROS,293,148,0,499,0,0,11,6,3,3,0,0,164,0,834,12,846
6,MATAMOROS,294,185,0,336,0,0,29,10,3,3,0,0,127,0,693,17,710
6,MATAMOROS,295,50,0,193,0,0,7,3,1,3,0,0,129,0,386,9,395
6,MATAMOROS,296,121,0,386,0,0,6,10,5,3,0,0,95,0,626,16,642
6,MATAMOROS,297,375,0,547,0,0,46,12,6,2,0,0,101,0,1089,23,1112
6,MATAMOROS,298,161,0,355,0,0,30,7,8,2,0,0,55,0,618,18,636
6,MATAMOROS,299,74,0,183,0,0,3,8,1,1,0,0,53,0,323,17,340
6,MATAMOROS,300,75,0,163,0,0,5,1,3,1,0,0,99,0,347,9,356
6,MATAMOROS,301,124,0,131,0,0,2,23,10,1,0,0,55,0,346,22,368
6,MATAMOROS,302,79,0,218,0,0,11,43,8,6,0,0,101,0,466,12,478
6,MATAMOROS,303,205,0,284,0,0,14,11,3,1,0,0,18,0,536,17,553
6,MATAMOROS,304,300,0,274,0,0,9,28,4,4,0,0,70,0,689,26,715
6,MATAMOROS,305,332,0,800,0,0,27,46,14,9,0,0,43,0,1271,50,1321
6,MATAMOROS,306,282,0,561,0,0,4,36,8,2,0,0,102,0,995,33,1028
6,MATAMOROS,307,317,0,571,0,0,3,32,11,5,0,0,92,0,1031,24,1055
6,MATAMOROS,308,215,0,188,0,0,24,126,2,5,0,0,30,0,590,17,607
6,MATAMOROS,309,39,0,170,0,0,3,28,3,1,0,0,52,0,296,13,309
6,MATAMOROS,310,254,0,435,0,0,40,15,6,5,0,0,57,0,812,24,836
6,MATAMOROS,311,68,0,281,0,0,1,40,5,1,0,0,41,0,437,14,451
6,MATAMOROS,312,311,0,497,0,0,7,15,5,18,0,0,162,0,1015,52,1067
6,MATAMOROS,313,99,0,181,0,0,2,20,2,2,0,0,61,0,367,14,381
6,MATAMOROS,314,109,0,235,0,0,3,37,3,4,0,0,93,0,484,16,500
6,MATAMOROS,315,69,0,106,0,0,0,4,0,0,0,0,40,0,219,6,225
6,MATAMOROS,316,16,0,104,0,0,2,4,1,0,0,0,1,0,128,3,131
6,MATAMOROS,317,52,0,111,0,0,1,4,3,0,0,0,11,0,182,12,194
6,MATAMOROS,318,143,0,337,0,0,5,6,5,5,0,0,21,0,522,11,533
11,MONCLOVA,319,215,0,0,410,0,7,10,8,11,0,9,0,0,670,173,843
12,MONCLOVA,320,195,0,394,0,0,18,23,11,8,0,0,0,0,649,12,661
12,MONCLOVA,321,313,0,427,0,0,11,18,12,7,0,0,0,0,788,27,815
12,MONCLOVA,322,316,0,242,0,0,15,68,11,7,0,0,0,0,659,14,673
12,MONCLOVA,323,261,0,346,0,0,20,16,16,12,0,0,0,0,671,25,696
11,MONCLOVA,324,204,0,0,199,0,13,9,6,10,0,4,0,0,445,10,455
11,MONCLOVA,325,418,0,0,638,0,18,14,12,13,0,12,0,0,1125,30,1155
11,MONCLOVA,326,888,0,0,899,0,50,31,30,27,0,115,0,0,2040,51,2091
12,MONCLOVA,327,247,0,304,0,0,22,20,12,5,0,0,0,0,610,17,627
12,MONCLOVA,328,221,0,355,0,0,8,10,11,6,0,0,0,0,611,16,627
12,MONCLOVA,329,158,0,275,0,0,5,9,6,7,0,0,0,0,460,10,470
12,MONCLOVA,330,236,0,310,0,0,5,23,7,5,0,0,0,0,586,17,603
12,MONCLOVA,331,323,0,470,0,0,1,20,16,1,0,0,0,0,831,17,848
11,MONCLOVA,332,673,0,0,402,0,18,12,16,23,0,8,0,0,1152,30,1182
11,MONCLOVA,333,785,0,0,868,0,42,28,32,17,0,15,0,0,1787,24,1811
11,MONCLOVA,334,615,0,0,364,0,34,19,14,12,0,6,0,0,1064,22,1086
11,MONCLOVA,335,498,0,0,422,0,19,25,16,18,0,3,0,0,1001,20,1021
12,MONCLOVA,336,322,0,266,0,0,11,13,9,6,0,0,0,0,627,15,642
12,MONCLOVA,337,702,0,1116,0,0,29,50,36,10,0,0,0,0,1943,57,2000
12,MONCLOVA,338,238,0,348,0,0,8,16,6,11,0,0,0,0,627,18,645
12,MONCLOVA,339,278,0,421,0,0,15,19,23,8,0,0,0,0,764,23,787
12,MONCLOVA,340,346,0,296,0,0,22,23,6,5,0,0,0,0,698,22,720
11,MONCLOVA,341,436,0,0,423,0,8,24,11,7,0,4,0,0,913,31,944
11,MONCLOVA,342,389,0,0,358,0,21,13,7,13,0,4,0,0,805,34,839
11,MONCLOVA,343,372,0,0,321,0,11,19,16,20,0,10,0,0,769,25,794
11,MONCLOVA,344,306,0,0,330,0,20,20,8,16,0,9,0,0,709,20,729
12,MONCLOVA,345,326,0,335,0,0,24,31,12,5,0,0,0,0,733,24,757
12,MONCLOVA,346,254,0,340,0,0,11,21,19,6,0,0,0,0,651,21,672
12,MONCLOVA,347,411,0,586,0,0,10,21,32,6,0,0,0,0,1066,24,1090
12,MONCLOVA,348,316,0,465,0,0,11,16,13,6,0,0,0,0,827,35,862
12,MONCLOVA,349,307,0,430,0,0,4,13,39,10,0,0,0,0,803,23,826
12,MONCLOVA,350,337,0,389,0,0,2,8,10,5,0,0,0,0,751,30,781
12,MONCLOVA,351,278,0,478,0,0,14,16,37,3,0,0,0,0,826,28,854
12,MONCLOVA,352,234,0,359,0,0,12,12,6,5,0,0,0,0,628,22,650
12,MONCLOVA,353,245,0,274,0,0,22,19,5,7,0,0,0,0,572,18,590
12,MONCLOVA,354,153,0,143,0,0,8,3,7,3,0,0,0,0,317,197,514
11,MONCLOVA,355,448,0,0,222,0,22,7,8,11,0,2,0,0,720,21,741
11,MONCLOVA,356,368,0,0,467,0,15,16,15,17,0,2,0,0,900,28,928
11,MONCLOVA,357,902,0,0,414,0,34,29,19,27,0,9,0,0,1434,44,1478
12,MONCLOVA,358,230,0,229,0,0,5,11,5,3,0,0,0,0,483,8,491
12,MONCLOVA,359,207,0,348,0,0,8,11,22,6,0,0,0,0,602,14,616
12,MONCLOVA,360,265,0,374,0,0,5,14,18,5,0,0,0,0,681,22,703
12,MONCLOVA,361,300,0,479,0,0,13,28,13,18,0,0,0,0,851,28,879
12,MONCLOVA,362,406,0,497,0,0,10,29,26,9,0,0,0,0,977,25,1002
12,MONCLOVA,363,117,0,272,0,0,3,8,7,3,0,0,0,0,410,9,419
12,MONCLOVA,364,278,0,447,0,0,20,9,7,6,0,0,0,0,767,28,795
12,MONCLOVA,365,182,0,236,0,0,1,8,11,1,0,0,0,0,439,8,447
12,MONCLOVA,366,155,0,123,0,0,11,7,2,2,0,0,0,0,300,9,309
12,MONCLOVA,367,240,0,291,0,0,13,21,9,4,0,0,0,0,578,10,588
12,MONCLOVA,368,377,0,236,0,0,13,11,3,12,0,0,0,0,652,19,671
11,MONCLOVA,369,565,0,0,361,0,14,10,12,25,0,4,0,0,991,35,1026
11,MONCLOVA,370,314,0,0,659,0,13,23,15,10,0,2,0,0,1036,38,1074
11,MONCLOVA,371,332,0,0,661,0,11,17,34,11,0,3,0,0,1069,30,1099
11,MONCLOVA,372,531,0,0,405,0,21,17,29,18,0,10,0,0,1031,27,1058
11,MONCLOVA,373,513,0,0,293,0,21,15,25,17,0,4,0,0,888,20,908
12,MONCLOVA,374,204,0,209,0,0,10,12,10,3,0,0,0,0,448,4,452
12,MONCLOVA,375,183,0,178,0,0,11,12,5,5,0,0,0,0,394,11,405
12,MONCLOVA,376,214,0,410,0,0,6,19,5,3,0,0,0,0,657,30,687
12,MONCLOVA,377,613,0,834,0,0,11,49,19,18,0,0,0,0,1544,42,1586
12,MONCLOVA,378,298,0,311,0,0,8,31,14,30,0,0,0,0,692,27,719
12,MONCLOVA,379,231,0,462,0,0,19,28,11,4,0,0,0,0,755,32,787
12,MONCLOVA,380,187,0,158,0,0,8,15,6,4,0,0,0,0,378,8,386
12,MONCLOVA,381,319,0,254,0,0,10,8,8,10,0,0,0,0,609,19,628
11,MONCLOVA,382,368,0,0,359,0,10,15,12,14,0,3,0,0,781,20,801
11,MONCLOVA,383,585,0,0,347,0,14,14,55,19,0,4,0,0,1038,21,1059
11,MONCLOVA,384,262,0,0,595,0,8,6,11,13,0,2,0,0,897,17,914
11,MONCLOVA,385,408,0,0,521,0,15,22,25,7,0,11,0,0,1009,23,1032
11,MONCLOVA,386,228,0,0,423,0,17,11,12,7,0,3,0,0,701,16,717
11,MONCLOVA,387,310,0,0,496,0,15,24,17,4,0,3,0,0,869,24,893
11,MONCLOVA,388,166,0,0,247,0,4,9,4,5,0,4,0,0,439,11,450
11,MONCLOVA,389,190,0,0,272,0,16,9,6,5,0,0,0,0,498,12,510
11,MONCLOVA,390,370,0,0,289,0,14,14,14,4,0,4,0,0,709,24,733
12,MONCLOVA,391,251,0,231,0,0,7,15,13,11,0,0,0,0,528,15,543
12,MONCLOVA,392,295,0,319,0,0,14,25,10,6,0,0,0,0,669,17,686
12,MONCLOVA,393,191,0,246,0,0,13,17,6,2,0,0,0,0,475,8,483
12,MONCLOVA,394,147,0,134,0,0,1,1,1,0,0,0,0,0,284,3,287
12,MONCLOVA,395,179,0,284,0,0,8,16,12,0,0,0,0,0,499,12,511
12,MONCLOVA,396,283,0,345,0,0,6,29,8,6,0,0,0,0,677,19,696
12,MONCLOVA,397,287,0,377,0,0,12,32,16,6,0,0,0,0,730,9,739
12,MONCLOVA,398,388,0,429,0,0,9,28,15,5,0,0,0,0,874,23,897
12,MONCLOVA,399,300,0,414,0,0,19,24,14,6,0,0,0,0,777,275,1052
12,MONCLOVA,400,236,0,146,0,0,8,7,6,2,0,0,0,0,405,15,420
12,MONCLOVA,401,228,0,172,0,0,14,19,8,2,0,0,0,0,443,5,448
11,MONCLOVA,402,330,0,0,354,0,15,16,16,9,0,3,0,0,743,28,771
11,MONCLOVA,403,232,0,0,288,0,3,15,16,3,0,3,0,0,560,17,577
11,MONCLOVA,404,318,0,0,386,0,13,15,18,2,0,5,0,0,757,26,783
11,MONCLOVA,405,320,0,0,389,0,10,24,13,7,0,0,0,0,763,16,779
11,MONCLOVA,406,274,0,0,405,0,8,13,6,7,0,2,0,0,715,26,741
11,MONCLOVA,407,353,0,0,434,0,13,14,13,9,0,1,0,0,837,28,865
11,MONCLOVA,408,337,0,0,351,0,15,18,10,4,0,0,0,0,735,12,747
12,MONCLOVA,409,181,0,136,0,0,5,12,5,2,0,0,0,0,341,9,350
12,MONCLOVA,410,210,0,278,0,0,14,11,8,3,0,0,0,0,524,14,538
12,MONCLOVA,411,226,0,248,0,0,8,25,4,4,0,0,0,0,515,10,525
12,MONCLOVA,412,408,0,480,0,0,24,21,32,8,0,0,0,0,973,26,999
12,MONCLOVA,413,323,0,441,0,0,8,17,22,5,0,0,0,0,816,17,833
12,MONCLOVA,414,205,0,424,0,0,6,20,10,3,0,0,0,0,668,18,686
12,MONCLOVA,415,306,0,567,0,0,12,38,21,2,0,0,0,0,946,19,965
12,MONCLOVA,416,355,0,496,0,0,16,22,17,6,0,0,0,0,912,29,941
11,MONCLOVA,417,237,0,0,280,0,10,13,3,3,0,2,0,0,548,13,561
11,MONCLOVA,418,146,0,0,163,0,2,5,4,6,0,1,0,0,327,14,341
12,MONCLOVA,419,385,0,425,0,0,21,15,6,7,0,0,0,0,859,22,881
12,MONCLOVA,420,306,0,358,0,0,9,20,6,9,0,0,0,0,708,17,725
12,MONCLOVA,421,130,0,242,0,0,7,8,17,4,0,0,0,0,408,9,417
12,MONCLOVA,422,303,0,429,0,0,14,18,9,2,0,0,0,0,775,28,803
12,MONCLOVA,423,87,0,107,0,0,5,6,2,9,0,0,0,0,216,10,226
12,MONCLOVA,424,313,0,258,0,0,17,60,8,32,0,0,0,0,688,37,725
12,MONCLOVA,425,268,0,274,0,0,20,43,11,10,0,0,0,0,626,16,642
12,MONCLOVA,426,154,0,313,0,0,13,24,10,5,0,0,0,0,519,7,526
12,MONCLOVA,427,200,0,371,0,0,13,13,9,7,0,0,0,0,613,14,627
12,MONCLOVA,428,321,0,277,0,0,14,30,9,18,0,0,0,0,669,16,685
12,MONCLOVA,429,267,0,258,0,0,33,56,13,15,0,0,0,0,642,25,667
12,MONCLOVA,430,332,0,370,0,0,20,44,16,8,0,0,0,0,790,20,810
12,MONCLOVA,431,801,0,1225,0,0,31,89,26,30,0,0,0,0,2202,61,2263
12,MONCLOVA,432,258,0,326,0,0,11,18,10,5,0,0,0,0,628,31,659
12,MONCLOVA,433,403,0,418,0,0,23,73,14,8,0,0,0,0,939,29,968
12,MONCLOVA,434,310,0,306,0,0,16,129,11,7,0,0,0,0,779,18,797
12,MONCLOVA,435,180,0,167,0,0,3,9,5,16,0,0,0,0,380,9,389
12,MONCLOVA,436,859,0,967,0,0,53,110,36,22,0,0,0,0,2047,40,2087
12,MONCLOVA,437,319,0,484,0,0,39,87,12,5,0,0,0,0,946,22,968
12,MONCLOVA,438,399,0,500,0,0,71,61,15,27,0,0,0,0,1073,30,1103
12,MONCLOVA,439,350,0,292,0,0,16,33,12,10,0,0,0,0,713,16,729
12,MONCLOVA,440,177,0,251,0,0,4,14,4,2,0,0,0,0,452,4,456
12,MONCLOVA,441,566,0,245,0,0,16,27,9,3,0,0,0,0,866,9,875
12,MONCLOVA,442,82,0,121,0,0,3,6,4,2,0,0,0,0,218,6,224
12,MONCLOVA,443,17,0,32,0,0,7,0,2,5,0,0,0,0,63,0,63
14,MORELOS,444,320,0,361,0,0,8,1,6,3,0,0,0,0,699,17,716
14,MORELOS,445,328,0,339,0,0,12,5,6,1,0,0,0,0,691,17,708
14,MORELOS,446,334,0,391,0,0,17,7,5,2,0,0,0,0,756,9,765
14,MORELOS,447,277,0,338,0,0,6,8,5,2,0,0,0,0,636,24,660
14,MORELOS,448,223,0,350,0,0,3,5,2,3,0,0,0,0,586,9,595
14,MORELOS,449,214,0,324,0,0,7,3,3,10,0,0,0,0,561,17,578
13,MUZQUIZ,450,429,0,0,0,469,5,45,12,7,6,0,25,3,1001,197,1198
13,MUZQUIZ,451,469,0,0,0,368,20,25,10,8,2,2,10,1,915,37,952
13,MUZQUIZ,452,370,0,0,0,380,16,29,11,5,1,2,33,1,848,31,879
13,MUZQUIZ,453,342,0,0,0,398,12,14,11,4,2,0,13,2,798,33,831
13,MUZQUIZ,454,448,0,0,0,413,17,27,7,7,1,0,7,3,930,24,954
13,MUZQUIZ,455,310,0,0,0,375,4,5,2,5,0,1,11,1,714,15,729
13,MUZQUIZ,456,229,0,0,0,356,7,34,9,2,3,1,5,2,648,28,676
13,MUZQUIZ,457,378,0,0,0,361,20,14,4,4,5,3,17,4,810,17,827
13,MUZQUIZ,458,564,0,0,0,701,30,27,17,2,13,3,26,1,1384,67,1451
13,MUZQUIZ,459,241,0,0,0,298,14,13,9,3,2,2,35,0,617,21,638
13,MUZQUIZ,460,355,0,0,0,420,19,18,8,3,2,3,52,2,882,18,900
13,MUZQUIZ,461,341,0,0,0,442,13,20,5,1,4,0,13,2,841,23,864
13,MUZQUIZ,462,328,0,0,0,274,28,10,3,5,5,2,20,3,678,20,698
13,MUZQUIZ,463,272,0,0,0,340,18,13,7,1,1,0,35,2,689,13,702
13,MUZQUIZ,464,317,0,0,0,322,11,10,4,5,2,3,10,1,685,32,717
13,MUZQUIZ,465,142,0,0,0,149,8,0,3,1,0,0,8,0,311,1,312
13,MUZQUIZ,466,214,0,0,0,133,5,3,3,8,1,1,7,0,375,4,379
13,MUZQUIZ,467,339,0,0,0,310,24,20,4,2,3,1,16,9,728,24,752
13,MUZQUIZ,468,254,0,0,0,424,16,20,7,5,4,1,17,1,749,24,773
13,MUZQUIZ,469,357,0,0,0,463,9,21,5,7,2,1,15,1,881,25,906
13,MUZQUIZ,470,380,0,0,0,509,17,22,11,6,4,6,19,1,975,30,1005
13,MUZQUIZ,473,148,0,0,0,153,5,18,4,1,0,1,4,1,335,22,357
13,MUZQUIZ,474,137,0,0,0,187,6,2,2,2,1,0,2,2,341,20,361
13,MUZQUIZ,475,341,0,0,0,532,5,14,3,1,7,1,13,0,917,21,938
13,MUZQUIZ,476,308,0,0,0,380,25,15,4,2,3,1,5,1,744,10,754
13,MUZQUIZ,477,185,0,0,0,371,15,5,6,3,4,2,7,0,598,15,613
13,MUZQUIZ,478,294,0,0,0,478,23,9,1,1,7,2,16,3,834,16,850
13,MUZQUIZ,479,395,0,0,0,426,12,7,4,4,4,1,6,1,860,18,878
13,MUZQUIZ,480,219,0,0,0,319,12,14,2,1,1,2,13,0,583,11,594
13,MUZQUIZ,481,271,0,0,0,411,12,12,4,2,6,1,9,4,732,11,743
13,MUZQUIZ,482,257,0,0,0,310,7,9,3,2,3,2,13,0,606,11,617
13,MUZQUIZ,483,280,0,0,0,367,4,9,5,6,2,2,8,0,683,20,703
13,MUZQUIZ,484,164,0,0,0,273,3,6,2,2,3,1,11,0,465,8,473
13,MUZQUIZ,485,197,0,0,0,248,6,14,1,5,4,0,5,2,482,15,497
13,MUZQUIZ,486,254,0,0,0,304,9,6,7,1,4,2,5,0,592,14,606
13,MUZQUIZ,487,114,0,0,0,219,11,8,1,1,0,1,9,1,365,12,377
13,MUZQUIZ,488,119,0,0,0,183,6,5,2,3,1,1,2,3,325,10,335
13,MUZQUIZ,489,171,0,0,0,423,12,5,7,6,10,2,4,0,640,8,648
13,MUZQUIZ,490,198,0,0,0,391,4,8,3,3,4,0,2,5,618,17,635
13,MUZQUIZ,491,55,0,0,0,112,2,1,1,0,1,0,1,2,175,3,178
13,MUZQUIZ,492,346,0,0,0,667,24,7,2,4,2,3,7,1,1063,14,1077
13,MUZQUIZ,493,248,0,0,0,435,20,6,3,2,11,1,8,2,736,24,760
13,MUZQUIZ,494,122,0,0,0,188,3,3,1,0,0,7,0,0,324,5,329
13,MUZQUIZ,495,209,0,0,0,418,17,4,2,4,6,1,6,3,670,13,683
13,MUZQUIZ,496,157,0,0,0,223,11,2,3,0,1,0,2,0,399,7,406
13,MUZQUIZ,497,111,0,0,0,325,13,4,1,1,2,1,3,2,463,0,463
13,MUZQUIZ,498,106,0,0,0,212,2,4,4,1,4,1,1,0,335,6,341
13,MUZQUIZ,499,187,0,0,0,369,11,3,6,2,2,0,4,1,585,20,605
11,NADADORES,500,228,0,0,335,0,4,9,0,4,0,1,0,0,581,14,595
11,NADADORES,501,340,0,0,405,0,9,12,5,2,0,1,0,0,774,21,795
11,NADADORES,502,186,0,0,318,0,6,16,7,1,0,0,0,0,534,11,545
11,NADADORES,503,184,0,0,350,0,8,7,2,1,0,1,0,0,553,15,568
11,NADADORES,504,27,0,0,202,0,2,2,0,1,0,1,0,0,235,81,316
11,NADADORES,505,125,0,0,375,0,2,5,2,2,0,0,0,0,511,20,531
11,NADADORES,506,46,0,0,41,0,2,2,0,0,0,1,0,0,92,4,96
11,NADADORES,507,34,0,0,69,0,3,3,0,1,0,1,0,0,111,4,115
14,NAVA,508,490,0,555,0,0,15,10,5,3,0,0,0,0,1078,34,1112
14,NAVA,509,249,0,294,0,0,4,1,4,2,0,0,0,0,554,10,564
14,NAVA,510,360,0,561,0,0,16,5,6,3,0,0,0,0,951,18,969
14,NAVA,511,367,0,482,0,0,16,7,5,4,0,0,0,0,881,20,901
14,NAVA,512,463,0,593,0,0,12,7,8,8,0,0,0,0,1091,32,1123
14,NAVA,513,231,0,364,0,0,7,5,5,1,0,0,0,0,613,22,635
14,NAVA,514,202,0,329,0,0,8,4,1,0,0,0,0,0,544,10,554
14,NAVA,515,332,0,501,0,0,10,3,6,4,0,0,0,0,856,31,887
14,NAVA,516,376,0,532,0,0,14,8,11,9,0,0,0,0,950,30,980
14,NAVA,517,227,0,327,0,0,9,3,5,1,0,0,0,0,572,12,584
14,NAVA,518,422,0,668,0,0,11,6,5,3,0,0,0,0,1115,16,1131
14,NAVA,519,296,0,461,0,0,5,7,12,2,0,0,0,0,783,23,806
14,NAVA,520,89,0,162,0,0,5,6,2,1,0,0,0,0,265,18,283
14,NAVA,521,43,0,95,0,0,2,2,3,0,0,0,0,0,145,3,148
14,NAVA,522,29,0,18,0,0,1,2,0,0,0,0,0,0,50,1,51
14,NAVA,523,84,0,128,0,0,3,8,2,0,0,0,0,0,225,7,232
14,NAVA,525,7,0,20,0,0,0,0,0,0,0,0,0,0,27,1,28
11,OCAMPO,526,324,0,0,471,0,16,10,7,3,0,0,0,0,831,27,858
11,OCAMPO,527,195,0,0,412,0,18,16,4,5,0,3,0,0,653,14,667
11,OCAMPO,528,23,0,0,69,0,3,7,0,1,0,2,0,0,105,6,111
11,OCAMPO,529,49,0,0,98,0,0,2,0,1,0,0,0,0,150,3,153
11,OCAMPO,530,45,0,0,118,0,2,5,2,2,0,0,0,0,174,4,178
11,OCAMPO,531,22,0,0,48,0,1,0,1,0,0,0,0,0,72,1,73
11,OCAMPO,532,177,0,0,391,0,11,1,2,2,0,3,0,0,587,29,616
11,OCAMPO,533,2,0,0,8,0,0,0,0,0,0,0,0,0,10,0,10
11,OCAMPO,534,21,0,0,100,0,4,4,4,1,0,0,0,0,134,7,141
11,OCAMPO,535,19,0,0,84,0,0,0,1,0,0,1,0,0,105,2,107
11,OCAMPO,536,43,0,0,99,0,2,5,0,1,0,1,0,0,151,7,158
11,OCAMPO,537,57,0,0,60,0,5,2,1,3,0,0,0,0,128,4,132
11,OCAMPO,538,7,0,0,28,0,2,0,0,0,0,0,0,0,37,1,38
11,OCAMPO,539,70,0,0,191,0,5,3,2,1,0,0,0,0,272,5,277
11,OCAMPO,540,147,0,0,428,0,2,4,5,1,0,0,0,0,587,14,601
5,PARRAS,542,459,732,0,0,0,95,35,0,6,0,9,0,0,1336,43,1379
5,PARRAS,543,392,770,0,0,0,103,25,0,2,0,20,0,0,1312,33,1345
5,PARRAS,544,222,423,0,0,0,48,7,0,2,0,6,0,0,708,23,731
5,PARRAS,545,263,543,0,0,0,54,27,0,11,0,4,0,0,902,45,947
5,PARRAS,546,195,263,0,0,0,29,13,0,4,0,5,0,0,509,18,527
5,PARRAS,547,181,386,0,0,0,34,11,0,2,0,7,0,0,621,20,641
5,PARRAS,548,250,481,0,0,0,36,12,0,9,0,3,0,0,791,36,827
5,PARRAS,549,311,596,0,0,0,86,16,0,9,0,6,0,0,1024,42,1066
5,PARRAS,550,203,478,0,0,0,50,13,0,5,0,16,0,0,765,45,810
5,PARRAS,551,198,300,0,0,0,21,9,0,1,0,12,0,0,541,34,575
5,PARRAS,552,183,272,0,0,0,29,12,0,4,0,2,0,0,502,33,535
5,PARRAS,553,252,250,0,0,0,35,12,0,10,0,8,0,0,567,17,584
5,PARRAS,554,160,387,0,0,0,76,8,0,4,0,10,0,0,645,36,681
5,PARRAS,555,105,304,0,0,0,48,2,0,3,0,4,0,0,466,6,472
5,PARRAS,556,174,256,0,0,0,25,8,0,2,0,11,0,0,476,17,493
5,PARRAS,557,411,883,0,0,0,119,25,0,4,0,19,0,0,1461,60,1521
5,PARRAS,558,266,467,0,0,0,76,21,0,5,0,5,0,0,840,53,893
5,PARRAS,559,221,426,0,0,0,37,19,0,13,0,5,0,0,721,43,764
5,PARRAS,560,62,178,0,0,0,9,5,0,4,0,1,0,0,259,13,272
5,PARRAS,561,6,43,0,0,0,1,2,0,0,0,0,0,0,52,6,58
5,PARRAS,562,40,125,0,0,0,7,3,0,0,0,0,0,0,175,4,179
5,PARRAS,563,59,116,0,0,0,7,5,0,1,0,0,0,0,188,4,192
5,PARRAS,564,42,86,0,0,0,4,8,0,0,0,0,0,0,140,5,145
5,PARRAS,565,122,242,0,0,0,6,11,0,2,0,7,0,0,390,24,414
5,PARRAS,566,144,314,0,0,0,9,12,0,4,0,4,0,0,487,27,514
5,PARRAS,567,335,310,0,0,0,34,11,0,7,0,2,0,0,699,22,721
5,PARRAS,568,85,114,0,0,0,8,8,0,3,0,0,0,0,218,14,232
5,PARRAS,569,298,243,0,0,0,10,12,0,5,0,4,0,0,572,38,610
5,PARRAS,570,32,126,0,0,0,1,4,0,1,0,2,0,0,166,19,185
5,PARRAS,571,282,299,0,0,0,12,16,0,5,0,6,0,0,620,42,662
5,PARRAS,573,58,233,0,0,0,7,6,0,0,0,8,0,0,312,12,324
5,PARRAS,574,15,165,0,0,0,2,7,0,0,0,0,0,0,189,10,199
5,PARRAS,575,52,191,0,0,0,3,3,0,2,0,1,0,0,252,17,269
5,PARRAS,576,6,52,0,0,0,4,0,0,1,0,0,0,0,63,2,65
16,PIEDRAS NEGRAS,577,335,0,0,0,726,16,18,33,5,5,1,4,5,1148,27,1175
16,PIEDRAS NEGRAS,578,176,0,0,0,382,5,6,27,1,1,1,2,2,603,14,617
16,PIEDRAS NEGRAS,579,80,0,0,0,241,3,1,11,0,0,1,1,0,338,9,347
16,PIEDRAS NEGRAS,580,591,0,0,0,1430,28,21,75,3,3,1,3,3,2158,67,2225
16,PIEDRAS NEGRAS,581,274,0,0,0,801,11,9,30,6,0,2,3,5,1141,30,1171
16,PIEDRAS NEGRAS,582,70,0,0,0,152,5,1,12,2,0,1,1,0,244,4,248
16,PIEDRAS NEGRAS,583,91,0,0,0,206,7,7,8,0,0,1,0,0,320,35,355
16,PIEDRAS NEGRAS,584,64,0,0,0,156,6,2,10,3,0,0,2,2,245,2,247
16,PIEDRAS NEGRAS,585,229,0,0,0,630,20,10,35,1,2,1,5,4,937,33,970
16,PIEDRAS NEGRAS,586,791,0,0,0,1681,30,33,100,9,13,4,4,5,2670,72,2742
16,PIEDRAS NEGRAS,587,937,0,0,0,2143,58,43,137,6,13,6,10,7,3360,89,3449
16,PIEDRAS NEGRAS,588,349,0,0,0,597,25,14,56,2,3,5,6,4,1061,41,1102
16,PIEDRAS NEGRAS,589,60,0,0,0,147,2,0,5,0,0,0,0,0,214,8,222
16,PIEDRAS NEGRAS,590,76,0,0,0,151,3,3,8,0,3,0,2,0,246,5,251
16,PIEDRAS NEGRAS,591,112,0,0,0,216,8,2,18,0,2,1,1,0,360,13,373
16,PIEDRAS NEGRAS,592,69,0,0,0,185,8,1,10,0,1,0,2,2,278,13,291
16,PIEDRAS NEGRAS,593,206,0,0,0,265,9,4,41,2,2,1,0,2,532,16,548
16,PIEDRAS NEGRAS,594,455,0,0,0,272,20,5,47,6,1,1,0,0,807,11,818
16,PIEDRAS NEGRAS,595,413,0,0,0,416,17,3,71,5,4,1,1,2,933,30,963
16,PIEDRAS NEGRAS,596,67,0,0,0,227,9,2,8,1,2,1,0,3,320,7,327
16,PIEDRAS NEGRAS,597,148,0,0,0,198,13,3,28,1,4,1,0,4,400,13,413
16,PIEDRAS NEGRAS,598,141,0,0,0,185,6,5,18,0,3,0,0,1,359,10,369
16,PIEDRAS NEGRAS,599,84,0,0,0,118,5,1,7,2,0,1,0,0,218,0,218
16,PIEDRAS NEGRAS,600,126,0,0,0,178,8,6,21,2,0,0,0,2,343,10,353
16,PIEDRAS NEGRAS,601,307,0,0,0,543,23,6,48,0,2,3,1,3,936,23,959
16,PIEDRAS NEGRAS,602,148,0,0,0,276,19,5,15,1,0,0,1,3,468,9,477
16,PIEDRAS NEGRAS,603,100,0,0,0,161,7,5,10,2,4,0,0,0,289,4,293
16,PIEDRAS NEGRAS,604,60,0,0,0,103,3,0,4,0,2,0,0,2,174,1,175
16,PIEDRAS NEGRAS,605,78,0,0,0,165,1,3,5,0,2,0,0,0,254,6,260
16,PIEDRAS NEGRAS,606,359,0,0,0,194,14,8,46,3,2,1,6,4,637,13,650
16,PIEDRAS NEGRAS,607,112,0,0,0,170,4,1,11,0,0,0,0,0,298,5,303
16,PIEDRAS NEGRAS,608,110,0,0,0,235,7,3,16,1,1,0,0,6,379,12,391
16,PIEDRAS NEGRAS,609,130,0,0,0,266,11,12,24,2,5,1,1,4,456,13,469
16,PIEDRAS NEGRAS,610,225,0,0,0,302,8,9,13,1,5,1,1,6,571,20,591
16,PIEDRAS NEGRAS,612,477,0,0,0,431,41,17,77,5,5,0,3,3,1059,38,1097
16,PIEDRAS NEGRAS,613,276,0,0,0,576,19,16,24,9,2,1,7,1,931,25,956
16,PIEDRAS NEGRAS,614,176,0,0,0,388,12,10,20,1,0,0,1,2,610,11,621
16,PIEDRAS NEGRAS,615,122,0,0,0,240,7,2,16,0,1,1,2,1,392,12,404
16,PIEDRAS NEGRAS,616,72,0,0,0,218,6,2,10,0,2,1,1,1,313,5,318
16,PIEDRAS NEGRAS,617,135,0,0,0,360,5,4,20,1,4,0,2,2,533,12,545
16,PIEDRAS NEGRAS,618,209,0,0,0,605,16,9,17,1,3,1,2,5,868,18,886
16,PIEDRAS NEGRAS,619,128,0,0,0,271,6,8,5,2,3,1,0,1,425,13,438
16,PIEDRAS NEGRAS,620,156,0,0,0,426,9,4,15,1,1,1,1,0,614,25,639
16,PIEDRAS NEGRAS,621,313,0,0,0,542,14,6,20,4,1,4,2,0,906,32,938
16,PIEDRAS NEGRAS,622,336,0,0,0,1116,21,20,32,5,7,2,4,2,1545,50,1595
16,PIEDRAS NEGRAS,623,902,0,0,0,2078,64,26,144,7,14,10,8,8,3261,65,3326
16,PIEDRAS NEGRAS,624,189,0,0,0,372,20,6,36,3,6,2,0,0,634,18,652
16,PIEDRAS NEGRAS,625,144,0,0,0,305,7,4,15,0,1,1,1,2,480,11,491
16,PIEDRAS NEGRAS,626,161,0,0,0,360,6,7,23,0,1,0,0,0,558,13,571
16,PIEDRAS NEGRAS,627,304,0,0,0,420,33,16,40,1,2,2,2,3,823,20,843
16,PIEDRAS NEGRAS,628,268,0,0,0,465,30,12,53,5,6,0,2,3,844,10,854
16,PIEDRAS NEGRAS,629,98,0,0,0,176,3,3,6,1,0,1,0,0,288,3,291
16,PIEDRAS NEGRAS,630,154,0,0,0,596,13,9,24,2,4,2,2,1,807,18,825
16,PIEDRAS NEGRAS,631,191,0,0,0,575,8,11,31,2,1,3,2,0,824,20,844
16,PIEDRAS NEGRAS,632,139,0,0,0,307,7,7,21,2,3,0,0,1,487,22,509
16,PIEDRAS NEGRAS,633,1127,0,0,0,2189,114,35,151,18,15,6,17,6,3678,62,3740
16,PIEDRAS NEGRAS,634,105,0,0,0,190,10,8,12,0,0,1,1,2,329,2,331
16,PIEDRAS NEGRAS,635,383,0,0,0,1095,22,22,59,4,7,2,2,9,1605,43,1648
16,PIEDRAS NEGRAS,636,210,0,0,0,310,8,8,20,1,4,0,0,1,562,18,580
16,PIEDRAS NEGRAS,637,181,0,0,0,303,19,4,12,0,1,0,1,0,521,13,534
16,PIEDRAS NEGRAS,638,375,0,0,0,737,15,15,39,5,7,1,2,7,1203,34,1237
16,PIEDRAS NEGRAS,639,315,0,0,0,535,11,11,31,6,2,2,3,5,921,21,942
16,PIEDRAS NEGRAS,640,519,0,0,0,1278,24,14,38,8,5,4,9,3,1902,64,1966
16,PIEDRAS NEGRAS,641,244,0,0,0,491,9,10,15,1,5,2,2,1,780,26,806
16,PIEDRAS NEGRAS,642,46,0,0,0,145,2,2,5,0,1,0,0,0,201,6,207
16,PIEDRAS NEGRAS,643,43,0,0,0,200,7,4,4,1,3,0,0,0,262,7,269
16,PIEDRAS NEGRAS,644,54,0,0,0,91,2,3,0,0,1,0,0,0,151,2,153
13,PROGRESO,645,59,0,0,0,151,1,2,1,0,0,0,0,1,215,3,218
13,PROGRESO,646,102,0,0,0,162,3,6,2,4,0,0,2,0,281,7,288
13,PROGRESO,647,43,0,0,0,332,0,2,0,4,0,0,1,0,382,11,393
13,PROGRESO,648,150,0,0,0,202,3,4,4,3,3,0,0,1,370,12,382
13,PROGRESO,649,137,0,0,0,244,4,5,2,0,0,1,1,3,397,14,411
13,PROGRESO,650,88,0,0,0,180,5,3,5,5,1,1,0,2,290,7,297
5,RAMOS ARIZPE,652,374,845,0,0,0,16,87,0,8,0,7,0,0,1337,41,1378
5,RAMOS ARIZPE,653,1253,3218,0,0,0,42,131,0,30,0,14,0,0,4688,164,4852
5,RAMOS ARIZPE,654,224,447,0,0,0,13,92,0,3,0,2,0,0,781,32,813
5,RAMOS ARIZPE,655,141,287,0,0,0,6,137,0,4,0,1,0,0,576,19,595
5,RAMOS ARIZPE,656,274,286,0,0,0,10,68,0,4,0,1,0,0,643,15,658
5,RAMOS ARIZPE,657,231,315,0,0,0,9,82,0,4,0,5,0,0,646,18,664
5,RAMOS ARIZPE,658,249,292,0,0,0,11,37,0,4,0,2,0,0,595,9,604
5,RAMOS ARIZPE,659,222,373,0,0,0,13,97,0,7,0,0,0,0,712,15,727
5,RAMOS ARIZPE,660,316,629,0,0,0,19,55,0,6,0,4,0,0,1029,26,1055
5,RAMOS ARIZPE,661,353,816,0,0,0,24,53,0,9,0,5,0,0,1260,47,1307
5,RAMOS ARIZPE,662,202,326,0,0,0,10,38,0,6,0,2,0,0,584,23,607
5,RAMOS ARIZPE,663,1406,1857,0,0,0,61,131,0,23,0,14,0,0,3492,122,3614
5,RAMOS ARIZPE,664,1905,2653,0,0,0,61,180,0,36,0,24,0,0,4859,111,4970
5,RAMOS ARIZPE,665,12,46,0,0,0,0,4,0,0,0,0,0,0,62,4,66
5,RAMOS ARIZPE,666,12,157,0,0,0,0,1,0,0,0,0,0,0,170,5,175
5,RAMOS ARIZPE,667,32,92,0,0,0,2,6,0,0,0,1,0,0,133,0,133
5,RAMOS ARIZPE,668,16,39,0,0,0,1,2,0,0,0,1,0,0,59,3,62
5,RAMOS ARIZPE,669,115,125,0,0,0,5,11,0,1,0,1,0,0,258,10,268
5,RAMOS ARIZPE,670,77,89,0,0,0,2,3,0,2,0,0,0,0,173,5,178
5,RAMOS ARIZPE,671,80,122,0,0,0,4,4,0,1,0,0,0,0,211,6,217
5,RAMOS ARIZPE,672,16,33,0,0,0,0,4,0,0,0,0,0,0,53,1,54
5,RAMOS ARIZPE,673,182,343,0,0,0,2,5,0,9,0,1,0,0,542,32,574
5,RAMOS ARIZPE,674,23,90,0,0,0,1,3,0,2,0,0,0,0,119,5,124
5,RAMOS ARIZPE,675,7,31,0,0,0,0,0,0,0,0,0,0,0,38,0,38
5,RAMOS ARIZPE,676,70,197,0,0,0,3,1,0,3,0,0,0,0,274,14,288
5,RAMOS ARIZPE,677,65,210,0,0,0,2,2,0,1,0,1,0,0,281,15,296
5,RAMOS ARIZPE,678,13,24,0,0,0,0,2,0,0,0,0,0,0,39,1,40
5,RAMOS ARIZPE,679,13,65,0,0,0,1,2,0,1,0,0,0,0,82,0,82
5,RAMOS ARIZPE,680,12,48,0,0,0,2,1,0,0,0,0,0,0,63,0,63
5,RAMOS ARIZPE,681,34,105,0,0,0,1,4,0,0,0,0,0,0,144,12,156
5,RAMOS ARIZPE,682,8,84,0,0,0,1,1,0,0,0,0,0,0,94,3,97
5,RAMOS ARIZPE,683,27,105,0,0,0,1,3,0,1,0,0,0,0,137,14,151
5,RAMOS ARIZPE,684,55,111,0,0,0,0,3,0,1,0,2,0,0,172,19,191
5,RAMOS ARIZPE,685,61,197,0,0,0,7,10,0,1,0,1,0,0,277,9,286
5,RAMOS ARIZPE,686,32,154,0,0,0,6,3,0,1,0,2,0,0,198,11,209
5,RAMOS ARIZPE,687,13,82,0,0,0,0,2,0,0,0,0,0,0,97,2,99
5,RAMOS ARIZPE,688,15,167,0,0,0,2,1,0,0,0,1,0,0,186,7,193
5,RAMOS ARIZPE,689,28,95,0,0,0,0,1,0,1,0,0,0,0,125,4,129
5,RAMOS ARIZPE,690,50,74,0,0,0,1,1,0,1,0,0,0,0,127,3,130
14,SABINAS,691,660,0,365,0,0,8,3,7,2,0,0,0,0,1045,8,1053
14,SABINAS,692,2132,0,1292,0,0,28,26,33,38,0,0,0,0,3549,58,3607
14,SABINAS,693,1388,0,984,0,0,19,16,39,18,0,0,0,0,2464,49,2513
14,SABINAS,694,470,0,384,0,0,7,5,11,6,0,0,0,0,883,19,902
14,SABINAS,695,525,0,274,0,0,6,3,8,1,0,0,0,0,817,13,830
14,SABINAS,696,580,0,278,0,0,4,3,14,5,0,0,0,0,884,15,899
14,SABINAS,697,280,0,254,0,0,0,6,3,5,0,0,0,0,548,6,554
14,SABINAS,698,401,0,323,0,0,10,10,7,1,0,0,0,0,752,22,774
14,SABINAS,699,358,0,225,0,0,3,3,1,1,0,0,0,0,591,13,604
14,SABINAS,700,312,0,213,0,0,2,4,9,2,0,0,0,0,542,4,546
14,SABINAS,701,386,0,252,0,0,5,7,8,2,0,0,0,0,660,15,675
14,SABINAS,702,361,0,426,0,0,5,13,6,7,0,0,0,0,818,24,842
14,SABINAS,703,566,0,493,0,0,9,12,9,12,0,0,0,0,1101,33,1134
14,SABINAS,704,111,0,94,0,0,0,1,0,0,0,0,0,0,206,1,207
14,SABINAS,705,291,0,167,0,0,3,5,1,5,0,0,0,0,472,11,483
14,SABINAS,706,583,0,624,0,0,11,9,11,11,0,0,0,0,1249,35,1284
14,SABINAS,707,358,0,295,0,0,5,8,8,4,0,0,0,0,678,27,705
14,SABINAS,708,407,0,390,0,0,7,7,7,1,0,0,0,0,819,29,848
14,SABINAS,709,478,0,426,0,0,21,14,8,13,0,0,0,0,960,24,984
14,SABINAS,710,298,0,306,0,0,6,6,7,2,0,0,0,0,625,27,652
14,SABINAS,711,417,0,306,0,0,11,3,12,10,0,0,0,0,759,16,775
14,SABINAS,712,247,0,179,0,0,5,9,3,1,0,0,0,0,444,16,460
14,SABINAS,713,233,0,157,0,0,5,5,2,6,0,0,0,0,408,19,427
14,SABINAS,714,414,0,262,0,0,11,6,9,8,0,0,0,0,710,13,723
14,SABINAS,715,781,0,463,0,0,10,12,14,6,0,0,0,0,1286,33,1319
14,SABINAS,716,31,0,95,0,0,2,2,0,1,0,0,0,0,131,2,133
14,SABINAS,717,284,0,192,0,0,11,8,3,1,0,0,0,0,499,13,512
14,SABINAS,718,328,0,218,0,0,4,1,5,3,0,0,0,0,559,8,567
14,SABINAS,719,299,0,183,0,0,2,4,2,7,0,0,0,0,497,8,505
14,SABINAS,720,327,0,186,0,0,2,10,3,6,0,0,0,0,534,25,559
14,SABINAS,721,282,0,242,0,0,3,4,1,3,0,0,0,0,535,13,548
14,SABINAS,722,371,0,315,0,0,5,10,10,11,0,0,0,0,722,14,736
14,SABINAS,723,567,0,676,0,0,16,15,10,19,0,0,0,0,1303,38,1341
14,SABINAS,724,350,0,368,0,0,5,6,5,6,0,0,0,0,740,16,756
14,SABINAS,725,337,0,301,0,0,4,7,0,4,0,0,0,0,653,14,667
14,SABINAS,726,226,0,217,0,0,3,3,5,6,0,0,0,0,460,4,464
14,SABINAS,727,50,0,60,0,0,1,6,1,0,0,0,0,0,118,7,125
11,SACRAMENTO,728,200,0,0,453,0,1,4,1,1,0,4,0,0,664,15,679
11,SACRAMENTO,729,187,0,0,443,0,2,7,1,5,0,1,0,0,646,13,659
4,SALTILLO,730,589,0,0,0,475,23,20,15,3,4,0,3,2,1134,52,1186
1,SALTILLO,731,1132,0,0,0,1433,24,52,26,16,3,5,5,0,2696,88,2784
4,SALTILLO,732,503,0,0,0,500,26,15,24,6,7,0,2,1,1084,62,1146
1,SALTILLO,733,815,0,0,0,583,6,9,17,10,7,1,1,1,1450,43,1493
1,SALTILLO,734,1860,0,0,0,1086,30,46,26,5,20,1,5,4,3083,93,3176
4,SALTILLO,735,233,0,0,0,420,3,11,15,2,3,0,0,4,691,22,713
4,SALTILLO,736,318,0,0,0,611,10,12,18,6,3,1,0,2,981,31,1012
4,SALTILLO,737,272,0,0,0,998,17,15,14,8,4,0,0,1,1329,36,1365
4,SALTILLO,738,285,0,0,0,1221,21,25,15,2,3,13,3,1,1589,48,1637
4,SALTILLO,739,182,0,0,0,488,10,18,15,5,4,0,3,4,729,22,751
1,SALTILLO,740,831,0,0,0,350,6,14,8,3,4,1,0,6,1223,49,1272
4,SALTILLO,741,324,0,0,0,228,10,3,8,3,4,1,0,0,581,16,597
4,SALTILLO,742,397,0,0,0,558,17,12,15,9,8,3,0,2,1021,36,1057
4,SALTILLO,743,411,0,0,0,322,21,17,7,3,8,2,0,1,792,33,825
4,SALTILLO,744,464,0,0,0,821,25,18,15,7,5,2,0,203,1560,45,1605
4,SALTILLO,745,562,0,0,0,1028,33,33,37,19,2,7,3,0,1724,369,2093
4,SALTILLO,746,382,0,0,0,1327,23,17,33,7,5,3,0,3,1800,61,1861
4,SALTILLO,747,154,0,0,0,540,19,8,8,2,2,0,0,0,733,20,753
4,SALTILLO,748,176,0,0,0,623,15,11,14,4,2,1,1,2,849,25,874
4,SALTILLO,749,273,0,0,0,261,9,14,6,3,4,0,1,1,572,24,596
4,SALTILLO,750,486,0,0,0,372,10,18,13,2,5,0,0,0,906,44,950
1,SALTILLO,751,1228,0,0,0,857,40,46,40,8,12,4,2,2,2239,79,2318
1,SALTILLO,752,1999,0,0,0,1794,73,111,69,12,26,7,8,15,4114,169,4283
1,SALTILLO,753,471,0,0,0,491,21,22,19,5,3,1,2,4,1039,51,1090
1,SALTILLO,754,276,0,0,0,706,10,8,7,4,3,0,0,6,1020,38,1058
1,SALTILLO,755,908,0,0,0,2590,37,43,39,9,10,1,5,7,3649,113,3762
1,SALTILLO,756,265,0,0,0,552,16,13,4,5,1,5,0,0,861,29,890
1,SALTILLO,757,431,0,0,0,797,27,39,20,8,13,1,2,5,1343,55,1398
1,SALTILLO,758,344,0,0,0,518,21,14,12,5,2,3,3,0,922,40,962
1,SALTILLO,759,582,0,0,0,637,28,14,19,2,10,3,2,2,1299,32,1331
1,SALTILLO,760,185,0,0,0,291,13,9,9,5,3,1,1,2,519,17,536
1,SALTILLO,761,243,0,0,0,401,12,2,10,10,6,1,0,1,686,21,707
4,SALTILLO,762,420,0,0,0,192,15,16,4,0,2,1,0,0,650,34,684
4,SALTILLO,763,428,0,0,0,482,17,15,22,3,7,1,1,2,978,35,1013
4,SALTILLO,764,547,0,0,0,455,14,29,19,5,8,2,1,2,1082,32,1114
4,SALTILLO,765,181,0,0,0,484,5,5,14,1,4,2,2,3,701,22,723
4,SALTILLO,766,1397,0,0,0,4035,88,59,70,32,28,15,9,309,6042,133,6175
4,SALTILLO,767,251,0,0,0,320,18,9,6,2,6,0,2,0,614,20,634
4,SALTILLO,768,439,0,0,0,1240,20,23,42,4,11,4,3,8,1794,50,1844
4,SALTILLO,769,127,0,0,0,590,11,14,18,2,6,2,0,0,770,31,801
4,SALTILLO,770,145,0,0,0,386,8,9,7,3,1,0,0,5,564,10,574
4,SALTILLO,771,245,0,0,0,793,10,20,14,5,7,21,0,0,1115,45,1160
4,SALTILLO,772,349,0,0,0,257,6,5,10,4,2,2,2,1,638,25,663
4,SALTILLO,773,360,0,0,0,148,5,1,6,3,5,1,0,0,529,15,544
1,SALTILLO,774,243,0,0,0,463,14,12,14,6,6,5,1,4,768,37,805
1,SALTILLO,775,248,0,0,0,387,11,11,16,0,13,6,0,2,694,24,718
1,SALTILLO,776,440,0,0,0,439,20,20,8,0,4,1,1,1,934,36,970
1,SALTILLO,777,868,0,0,0,2456,38,50,40,13,12,6,2,19,3504,96,3600
1,SALTILLO,778,381,0,0,0,442,15,14,16,4,5,4,1,2,884,26,910
1,SALTILLO,779,334,0,0,0,414,18,19,23,4,12,2,2,2,830,32,862
1,SALTILLO,780,258,0,0,0,371,15,9,14,4,2,1,1,6,681,16,697
4,SALTILLO,781,343,0,0,0,273,10,11,10,3,2,0,2,0,654,37,691
4,SALTILLO,782,260,0,0,0,243,10,7,16,4,1,1,1,3,546,28,574
4,SALTILLO,783,260,0,0,0,418,10,19,11,7,7,1,0,0,733,29,762
4,SALTILLO,784,301,0,0,0,191,7,18,6,3,1,1,0,1,529,20,549
4,SALTILLO,785,256,0,0,0,171,4,8,7,5,2,1,0,0,454,18,472
4,SALTILLO,786,364,0,0,0,222,13,9,8,7,5,1,0,0,629,28,657
4,SALTILLO,787,141,0,0,0,632,12,12,15,5,1,1,3,208,1030,45,1075
4,SALTILLO,788,187,0,0,0,731,3,13,8,7,2,4,0,4,959,38,997
4,SALTILLO,789,166,0,0,0,472,5,6,10,2,5,2,1,1,670,26,696
4,SALTILLO,790,260,0,0,0,961,20,13,15,4,3,2,1,3,1282,51,1333
4,SALTILLO,791,222,0,0,0,495,12,7,11,4,7,2,1,4,765,21,786
4,SALTILLO,792,192,0,0,0,743,16,12,20,7,3,0,0,0,993,25,1018
4,SALTILLO,793,152,0,0,0,517,18,13,19,0,4,1,0,1,725,13,738
4,SALTILLO,794,175,0,0,0,652,7,9,13,2,4,12,0,0,874,25,899
4,SALTILLO,795,261,0,0,0,787,16,20,10,2,2,2,4,6,1110,28,1138
4,SALTILLO,796,573,0,0,0,440,22,24,23,9,5,4,1,3,1104,53,1157
4,SALTILLO,797,275,0,0,0,165,11,7,3,2,0,0,2,0,465,16,481
4,SALTILLO,798,278,0,0,0,261,12,15,14,5,2,0,0,1,588,19,607
1,SALTILLO,799,222,0,0,0,292,7,7,10,6,0,0,0,2,546,14,560
1,SALTILLO,800,466,0,0,0,560,23,19,15,6,10,2,1,3,1105,43,1148
1,SALTILLO,801,356,0,0,0,472,12,16,10,7,11,0,1,4,889,18,907
1,SALTILLO,802,127,0,0,0,259,8,3,7,5,1,1,1,1,413,12,425
1,SALTILLO,803,136,0,0,0,410,12,3,6,3,3,3,0,2,578,21,599
1,SALTILLO,804,129,0,0,0,455,9,8,10,2,2,1,0,0,616,23,639
1,SALTILLO,805,135,0,0,0,465,6,14,8,2,4,1,0,0,635,20,655
1,SALTILLO,806,155,0,0,0,207,3,4,11,0,4,0,0,0,384,11,395
4,SALTILLO,807,212,0,0,0,366,8,10,10,6,3,2,1,1,619,24,643
4,SALTILLO,808,194,0,0,0,313,13,11,12,8,0,1,2,4,558,23,581
4,SALTILLO,809,134,0,0,0,258,10,11,7,2,1,0,0,3,426,25,451
4,SALTILLO,810,292,0,0,0,167,6,6,7,2,3,1,0,3,487,22,509
4,SALTILLO,811,206,0,0,0,163,2,7,3,1,0,0,2,2,386,13,399
4,SALTILLO,812,207,0,0,0,543,8,12,14,1,4,4,2,3,798,21,819
4,SALTILLO,813,172,0,0,0,387,7,12,7,2,1,0,0,0,588,22,610
4,SALTILLO,814,222,0,0,0,769,3,19,18,5,2,1,1,1,1041,19,1060
4,SALTILLO,815,144,0,0,0,453,9,9,8,2,2,3,3,2,635,30,665
4,SALTILLO,816,560,0,0,0,1564,52,42,39,6,7,3,2,0,2275,71,2346
4,SALTILLO,817,210,0,0,0,965,9,14,19,3,4,5,0,0,1229,21,1250
4,SALTILLO,818,120,0,0,0,698,5,12,11,0,4,3,0,0,853,28,881
4,SALTILLO,819,170,0,0,0,584,15,13,0,2,0,0,1,0,785,17,802
4,SALTILLO,820,198,0,0,0,459,5,15,7,2,3,3,1,0,693,14,707
4,SALTILLO,821,164,0,0,0,382,6,8,9,1,0,2,3,6,581,20,601
4,SALTILLO,822,138,0,0,0,395,6,11,10,1,3,0,0,0,564,10,574
4,SALTILLO,823,154,0,0,0,342,8,18,6,2,4,0,1,2,537,7,544
4,SALTILLO,824,104,0,0,0,297,7,5,3,3,3,11,0,1,434,16,450
4,SALTILLO,825,104,0,0,0,398,9,13,5,3,2,5,2,1,542,18,560
4,SALTILLO,826,141,0,0,0,225,4,6,9,6,0,1,1,5,398,21,419
4,SALTILLO,827,229,0,0,0,200,11,11,6,1,6,4,2,1,471,20,491
4,SALTILLO,828,179,0,0,0,411,9,13,19,2,2,1,2,0,638,17,655
1,SALTILLO,829,350,0,0,0,722,19,22,4,0,1,0,0,13,1131,19,1150
1,SALTILLO,830,1888,0,0,0,6585,105,117,133,62,43,10,16,21,8980,243,9223
1,SALTILLO,831,249,0,0,0,714,10,10,18,6,4,1,0,1,1013,22,1035
1,SALTILLO,832,395,0,0,0,1067,24,29,22,5,6,11,1,3,1563,47,1610
1,SALTILLO,833,325,0,0,0,466,20,22,10,9,6,3,1,2,864,38,902
2,SALTILLO,834,227,0,0,0,787,21,18,14,3,2,3,1,0,1076,32,1108
2,SALTILLO,835,113,0,0,0,505,3,8,5,3,3,1,1,0,642,21,663
2,SALTILLO,836,252,0,0,0,713,7,19,10,5,2,2,2,10,1022,19,1041
2,SALTILLO,837,127,0,0,0,408,12,8,7,3,5,1,1,0,572,21,593
2,SALTILLO,838,179,0,0,0,391,7,10,6,5,3,0,2,1,604,21,625
3,SALTILLO,839,185,0,0,0,275,12,17,5,3,3,1,3,3,507,20,527
3,SALTILLO,840,144,0,0,0,330,9,6,6,1,3,2,0,2,503,13,516
4,SALTILLO,841,134,0,0,0,224,9,8,12,13,4,1,0,0,405,18,423
4,SALTILLO,842,118,0,0,0,190,11,10,9,1,4,0,0,0,343,9,352
4,SALTILLO,843,165,0,0,0,237,9,10,6,1,3,1,0,3,435,16,451
4,SALTILLO,844,143,0,0,0,172,7,5,9,2,2,1,0,1,342,11,353
4,SALTILLO,845,130,0,0,0,192,5,5,2,1,4,3,0,2,344,20,364
4,SALTILLO,846,146,0,0,0,227,8,8,6,3,0,2,0,3,403,16,419
4,SALTILLO,847,294,0,0,0,338,5,16,12,3,13,2,1,4,688,32,720
4,SALTILLO,848,206,0,0,0,240,9,13,0,2,0,0,0,0,470,18,488
4,SALTILLO,849,62,0,0,0,210,11,7,1,2,0,1,0,2,296,9,305
4,SALTILLO,850,322,0,0,0,485,13,11,9,4,4,2,0,5,855,19,874
3,SALTILLO,851,210,0,0,0,408,25,8,7,5,6,3,0,0,672,29,701
4,SALTILLO,852,208,0,0,0,992,15,15,15,5,1,1,0,243,1495,27,1522
3,SALTILLO,853,223,0,0,0,804,20,13,18,3,5,0,1,1,1088,37,1125
3,SALTILLO,854,269,0,0,0,502,33,13,9,1,7,2,0,6,842,27,869
3,SALTILLO,855,289,0,0,0,376,22,11,2,5,3,3,1,3,715,26,741
3,SALTILLO,856,236,0,0,0,466,34,15,16,2,3,2,1,6,781,31,812
3,SALTILLO,857,243,0,0,0,242,10,8,0,4,2,0,1,2,512,13,525
4,SALTILLO,858,125,0,0,0,141,1,4,5,2,0,2,0,2,282,10,292
4,SALTILLO,859,193,0,0,0,208,10,11,5,2,3,1,1,0,434,16,450
4,SALTILLO,860,197,0,0,0,278,8,8,4,6,1,1,0,1,504,22,526
4,SALTILLO,861,179,0,0,0,227,7,5,9,3,2,1,1,2,436,22,458
3,SALTILLO,862,170,0,0,0,322,16,10,9,0,3,1,1,5,537,22,559
2,SALTILLO,863,187,0,0,0,482,18,12,10,2,3,1,2,3,720,21,741
2,SALTILLO,864,185,0,0,0,496,12,7,16,4,1,0,0,7,728,24,752
2,SALTILLO,865,273,0,0,0,448,11,15,14,4,4,1,1,2,773,28,801
2,SALTILLO,866,346,0,0,0,431,18,22,8,10,4,2,1,1,843,33,876
1,SALTILLO,867,284,0,0,0,573,13,12,19,6,3,1,0,2,913,27,940
1,SALTILLO,868,742,0,0,0,1600,46,34,30,13,13,6,3,1,2488,79,2567
1,SALTILLO,869,857,0,0,0,3464,53,50,66,25,31,5,7,12,4570,127,4697
1,SALTILLO,870,181,0,0,0,353,10,8,9,2,2,7,1,4,577,15,592
2,SALTILLO,871,304,0,0,0,346,11,10,4,0,6,3,1,2,687,29,716
2,SALTILLO,872,358,0,0,0,481,19,27,8,4,3,0,0,0,900,37,937
3,SALTILLO,873,185,0,0,0,382,23,8,11,7,0,2,1,0,619,25,644
3,SALTILLO,874,117,0,0,0,224,8,10,11,7,3,1,0,1,382,9,391
3,SALTILLO,875,142,0,0,0,220,12,12,7,1,1,2,0,2,399,28,427
3,SALTILLO,876,181,0,0,0,366,16,15,13,3,2,1,0,6,603,23,626
3,SALTILLO,877,150,0,0,0,266,13,16,2,2,4,2,1,6,462,18,480
3,SALTILLO,878,126,0,0,0,130,5,7,3,1,1,1,1,0,275,12,287
3,SALTILLO,879,144,0,0,0,243,16,7,6,1,1,1,0,2,421,14,435
3,SALTILLO,880,155,0,0,0,383,14,11,17,4,2,3,0,1,590,23,613
3,SALTILLO,881,139,0,0,0,195,13,7,8,3,0,0,0,1,366,16,382
3,SALTILLO,882,164,0,0,0,318,13,13,9,4,2,1,1,3,528,14,542
3,SALTILLO,883,212,0,0,0,739,24,11,6,7,4,3,0,0,1006,31,1037
3,SALTILLO,884,171,0,0,0,400,16,7,11,1,5,1,0,4,616,21,637
3,SALTILLO,885,109,0,0,0,520,10,6,6,1,1,0,0,1,654,16,670
3,SALTILLO,886,213,0,0,0,594,34,9,8,2,4,2,0,0,866,20,886
3,SALTILLO,887,153,0,0,0,544,24,11,6,5,1,1,1,1,747,32,779
3,SALTILLO,888,197,0,0,0,597,26,7,11,7,13,0,0,1,859,28,887
3,SALTILLO,889,141,0,0,0,485,18,5,5,1,6,0,0,0,661,24,685
3,SALTILLO,890,154,0,0,0,463,23,11,11,3,3,1,1,0,670,14,684
3,SALTILLO,891,187,0,0,0,329,12,10,4,4,3,0,0,3,552,21,573
3,SALTILLO,892,128,0,0,0,253,14,3,3,4,4,0,1,1,411,12,423
3,SALTILLO,893,194,0,0,0,312,6,14,6,4,1,3,2,1,543,23,566
3,SALTILLO,894,105,0,0,0,293,7,9,6,2,1,1,0,3,427,12,439
3,SALTILLO,895,126,0,0,0,485,10,5,9,3,3,4,1,10,656,17,673
3,SALTILLO,896,169,0,0,0,375,15,13,7,2,6,4,0,3,594,13,607
3,SALTILLO,897,235,0,0,0,443,17,10,13,6,10,0,2,6,742,35,777
3,SALTILLO,898,233,0,0,0,293,18,12,6,0,2,4,2,3,573,23,596
3,SALTILLO,899,208,0,0,0,329,20,7,9,7,2,2,0,4,588,17,605
3,SALTILLO,900,99,0,0,0,214,6,6,6,2,1,0,0,2,336,8,344
2,SALTILLO,901,125,0,0,0,202,5,18,11,1,2,1,1,0,366,19,385
2,SALTILLO,902,269,0,0,0,549,16,13,11,4,4,2,2,0,870,36,906
2,SALTILLO,903,139,0,0,0,648,8,14,6,4,5,1,0,5,830,26,856
1,SALTILLO,904,163,0,0,0,621,21,10,11,7,1,2,1,0,837,27,864
1,SALTILLO,905,709,0,0,0,2219,31,40,41,17,9,1,2,10,3079,93,3172
1,SALTILLO,906,251,0,0,0,792,18,15,16,3,4,0,0,1,1100,28,1128
2,SALTILLO,907,862,0,0,0,4914,64,57,46,13,25,18,6,22,6027,174,6201
2,SALTILLO,908,181,0,0,0,804,9,8,6,1,0,2,0,3,1014,28,1042
2,SALTILLO,909,281,0,0,0,783,22,21,20,4,7,2,1,1,1142,26,1168
2,SALTILLO,910,127,0,0,0,409,13,6,3,2,1,3,3,5,572,16,588
2,SALTILLO,911,165,0,0,0,479,14,12,11,4,4,3,3,4,699,27,726
3,SALTILLO,912,221,0,0,0,426,24,21,18,6,9,0,1,1,727,25,752
3,SALTILLO,913,115,0,0,0,396,15,12,14,1,2,1,6,5,567,32,599
3,SALTILLO,914,227,0,0,0,428,10,13,12,6,4,4,0,2,706,34,740
3,SALTILLO,915,141,0,0,0,398,5,10,4,3,4,2,1,0,568,21,589
3,SALTILLO,916,101,0,0,0,346,11,5,4,3,3,1,0,0,474,7,481
3,SALTILLO,917,117,0,0,0,331,11,4,7,2,6,1,2,1,482,14,496
3,SALTILLO,918,116,0,0,0,334,13,8,13,2,4,0,0,0,490,19,509
3,SALTILLO,919,233,0,0,0,384,20,11,13,5,9,2,0,2,679,22,701
3,SALTILLO,920,158,0,0,0,340,23,10,5,4,4,2,0,2,548,21,569
3,SALTILLO,921,159,0,0,0,472,15,6,7,2,1,1,1,0,664,24,688
3,SALTILLO,922,164,0,0,0,578,18,13,14,5,7,1,1,0,801,16,817
3,SALTILLO,923,108,0,0,0,663,13,7,10,2,5,5,1,1,815,26,841
3,SALTILLO,924,139,0,0,0,334,4,8,8,1,0,1,2,0,497,15,512
3,SALTILLO,925,139,0,0,0,407,14,6,8,2,6,2,0,0,584,26,610
3,SALTILLO,926,113,0,0,0,479,12,10,4,1,2,1,4,2,628,26,654
3,SALTILLO,927,117,0,0,0,461,10,10,6,2,0,2,2,0,610,20,630
3,SALTILLO,928,127,0,0,0,431,6,7,2,1,0,0,0,0,574,25,599
3,SALTILLO,929,142,0,0,0,689,28,13,13,5,3,2,1,2,898,22,920
3,SALTILLO,930,192,0,0,0,901,29,14,20,4,4,4,0,3,1171,51,1222
3,SALTILLO,931,122,0,0,0,452,13,10,7,4,1,1,3,3,616,30,646
3,SALTILLO,932,169,0,0,0,642,17,11,7,3,2,0,0,0,851,32,883
3,SALTILLO,933,132,0,0,0,420,14,8,7,1,6,1,0,0,589,16,605
3,SALTILLO,934,147,0,0,0,460,6,10,6,0,2,3,1,0,635,19,654
3,SALTILLO,935,122,0,0,0,420,15,12,7,2,2,3,1,0,584,25,609
3,SALTILLO,936,272,0,0,0,749,23,18,16,7,5,3,2,2,1097,38,1135
3,SALTILLO,937,233,0,0,0,553,21,20,10,1,1,2,0,0,841,27,868
2,SALTILLO,938,155,0,0,0,847,13,6,13,5,6,2,0,1,1048,24,1072
3,SALTILLO,939,146,0,0,0,383,13,7,8,1,4,0,0,1,563,24,587
3,SALTILLO,940,135,0,0,0,489,14,8,0,1,0,0,0,0,647,21,668
2,SALTILLO,941,205,0,0,0,557,14,8,9,5,1,0,1,4,804,21,825
2,SALTILLO,942,139,0,0,0,574,8,6,8,2,0,1,1,0,739,28,767
2,SALTILLO,943,864,0,0,0,3061,56,47,78,15,18,7,2,15,4163,109,4272
2,SALTILLO,944,71,0,0,0,359,8,7,3,1,1,6,0,0,456,22,478
2,SALTILLO,945,119,0,0,0,461,11,5,12,1,1,0,1,4,615,20,635
2,SALTILLO,946,215,0,0,0,1447,20,23,7,2,1,1,0,8,1724,46,1770
1,SALTILLO,947,146,0,0,0,352,8,8,15,5,1,1,4,0,540,18,558
1,SALTILLO,948,125,0,0,0,391,16,12,15,15,3,2,0,2,581,20,601
1,SALTILLO,949,562,0,0,0,1855,37,23,41,14,9,4,4,12,2561,67,2628
1,SALTILLO,950,324,0,0,0,1427,16,18,20,13,8,2,1,3,1832,56,1888
1,SALTILLO,951,100,0,0,0,489,9,13,1,3,3,0,0,0,618,14,632
2,SALTILLO,952,421,0,0,0,1514,31,30,35,6,9,5,4,8,2063,54,2117
2,SALTILLO,953,183,0,0,0,635,16,9,16,1,3,2,0,5,870,29,899
2,SALTILLO,954,165,0,0,0,595,13,10,16,4,2,0,3,0,808,23,831
2,SALTILLO,955,154,0,0,0,467,16,5,1,4,1,0,3,0,651,32,683
2,SALTILLO,956,187,0,0,0,575,16,21,19,6,3,0,0,2,829,32,861
2,SALTILLO,957,206,0,0,0,494,14,23,20,3,15,2,0,3,780,39,819
2,SALTILLO,958,237,0,0,0,503,19,15,9,3,6,2,1,10,805,27,832
3,SALTILLO,959,131,0,0,0,505,11,6,10,2,3,0,0,0,668,19,687
3,SALTILLO,960,128,0,0,0,422,11,7,7,1,6,0,1,2,585,15,600
3,SALTILLO,961,183,0,0,0,742,27,13,20,2,3,2,0,1,993,23,1016
3,SALTILLO,962,127,0,0,0,326,12,4,13,2,2,0,0,0,486,17,503
3,SALTILLO,963,143,0,0,0,552,8,27,15,6,4,1,1,3,760,19,779
3,SALTILLO,964,131,0,0,0,470,16,10,12,4,4,0,2,6,655,20,675
3,SALTILLO,965,162,0,0,0,597,15,10,18,3,5,1,1,1,813,23,836
3,SALTILLO,966,238,0,0,0,565,19,16,8,2,3,1,1,2,855,40,895
3,SALTILLO,967,192,0,0,0,808,14,13,9,1,1,0,1,2,1041,35,1076
3,SALTILLO,968,125,0,0,0,490,14,9,9,0,2,1,0,1,651,28,679
3,SALTILLO,969,229,0,0,0,1177,24,16,14,5,3,0,1,11,1480,33,1513
3,SALTILLO,970,675,0,0,0,2545,61,27,43,14,14,4,0,5,3388,137,3525
3,SALTILLO,971,277,0,0,0,603,23,23,17,11,5,1,0,3,963,22,985
3,SALTILLO,972,257,0,0,0,781,23,24,14,8,8,0,1,4,1120,25,1145
3,SALTILLO,973,219,0,0,0,753,15,21,16,3,2,5,1,4,1039,24,1063
3,SALTILLO,974,188,0,0,0,702,14,12,5,6,7,1,3,15,953,33,986
3,SALTILLO,975,195,0,0,0,636,13,17,13,2,3,1,2,1,883,25,908
2,SALTILLO,976,473,0,0,0,431,25,27,16,9,9,1,14,2,1007,34,1041
2,SALTILLO,977,560,0,0,0,1060,37,38,34,13,11,3,4,3,1763,78,1841
2,SALTILLO,978,206,0,0,0,617,10,8,16,2,2,0,0,1,862,36,898
2,SALTILLO,979,193,0,0,0,1201,22,18,13,3,11,5,0,4,1470,40,1510
2,SALTILLO,980,219,0,0,0,981,26,5,20,5,2,6,0,7,1271,37,1308
2,SALTILLO,981,278,0,0,0,1307,18,17,23,5,7,3,4,7,1669,57,1726
3,SALTILLO,982,179,0,0,0,481,18,14,15,3,8,0,0,5,723,25,748
3,SALTILLO,983,219,0,0,0,511,26,11,10,8,4,3,1,6,799,25,824
3,SALTILLO,984,196,0,0,0,577,35,30,17,6,1,1,0,3,866,23,889
3,SALTILLO,985,194,0,0,0,849,22,18,12,7,14,0,0,2,1118,38,1156
3,SALTILLO,986,165,0,0,0,787,18,8,9,1,0,3,4,2,997,35,1032
3,SALTILLO,987,510,0,0,0,2077,37,26,34,15,5,5,2,4,2715,105,2820
3,SALTILLO,988,439,0,0,0,368,16,21,17,0,7,1,2,1,872,49,921
3,SALTILLO,989,127,0,0,0,575,12,6,16,4,3,0,0,0,743,29,772
3,SALTILLO,990,341,0,0,0,608,24,23,26,6,11,1,1,4,1045,41,1086
3,SALTILLO,991,183,0,0,0,511,15,11,14,2,6,7,1,2,752,29,781
2,SALTILLO,992,1849,0,0,0,7502,127,111,135,33,48,12,14,10,9841,213,10054
2,SALTILLO,993,752,0,0,0,3581,60,68,69,22,27,3,6,24,4612,104,4716
2,SALTILLO,994,353,0,0,0,2718,23,20,40,3,7,14,2,9,3189,81,3270
2,SALTILLO,995,203,0,0,0,399,15,7,16,2,2,1,0,2,647,25,672
2,SALTILLO,996,188,0,0,0,421,12,25,12,5,2,1,0,1,667,30,697
2,SALTILLO,997,183,0,0,0,346,10,15,6,3,4,0,1,1,569,17,586
2,SALTILLO,998,165,0,0,0,603,17,14,17,3,9,0,0,0,828,27,855
2,SALTILLO,999,104,0,0,0,312,8,9,4,4,7,0,0,2,450,21,471
4,SALTILLO,1000,22,0,0,0,140,1,1,1,1,0,1,1,0,168,10,178
4,SALTILLO,1001,30,0,0,0,199,0,9,0,1,0,1,0,0,240,9,249
4,SALTILLO,1002,99,0,0,0,408,1,2,2,1,0,3,1,0,517,15,532
2,SALTILLO,1003,45,0,0,0,33,1,4,1,0,1,1,0,0,86,2,88
2,SALTILLO,1004,53,0,0,0,156,5,9,2,5,0,0,2,0,232,12,244
2,SALTILLO,1005,81,0,0,0,323,12,4,8,1,0,1,1,1,432,16,448
2,SALTILLO,1006,460,0,0,0,2215,27,27,33,19,11,5,2,4,2803,57,2860
2,SALTILLO,1007,16,0,0,0,212,1,2,3,0,0,0,0,0,234,6,240
2,SALTILLO,1008,64,0,0,0,167,0,6,1,2,0,0,1,0,241,11,252
2,SALTILLO,1009,84,0,0,0,423,6,11,5,3,0,0,1,0,533,15,548
2,SALTILLO,1010,20,0,0,0,192,0,4,2,2,0,0,0,0,220,9,229
2,SALTILLO,1011,181,0,0,0,667,15,15,15,4,0,2,0,6,905,23,928
2,SALTILLO,1012,15,0,0,0,88,0,2,2,1,0,1,0,0,109,7,116
2,SALTILLO,1013,21,0,0,0,135,2,5,0,0,1,0,0,0,164,6,170
2,SALTILLO,1014,118,0,0,0,719,6,11,10,1,0,0,1,0,866,21,887
2,SALTILLO,1015,43,0,0,0,177,2,1,4,0,2,0,0,11,240,0,240
2,SALTILLO,1016,18,0,0,0,171,0,2,0,0,0,0,0,0,191,5,196
2,SALTILLO,1017,4,0,0,0,65,2,0,0,0,0,0,0,0,71,2,73
2,SALTILLO,1018,8,0,0,0,52,0,2,0,2,0,0,0,0,64,3,67
2,SALTILLO,1019,16,0,0,0,153,1,5,0,0,1,0,0,0,176,5,181
2,SALTILLO,1020,18,0,0,0,50,2,3,0,0,0,0,0,0,73,6,79
2,SALTILLO,1021,1,0,0,0,101,0,0,0,0,0,0,0,0,102,6,108
2,SALTILLO,1022,29,0,0,0,95,1,2,1,0,0,0,0,0,128,14,142
2,SALTILLO,1023,18,0,0,0,148,1,1,1,3,1,0,0,2,175,7,182
2,SALTILLO,1024,10,0,0,0,74,0,0,0,0,0,0,0,0,84,1,85
2,SALTILLO,1025,21,0,0,0,165,1,4,0,1,0,0,0,0,192,4,196
2,SALTILLO,1026,57,0,0,0,183,0,8,3,1,1,1,1,0,255,6,261
2,SALTILLO,1027,34,0,0,0,110,0,1,3,0,0,0,0,0,148,1,149
2,SALTILLO,1028,4,0,0,0,85,0,0,1,0,0,0,0,0,90,7,97
2,SALTILLO,1029,35,0,0,0,170,2,1,1,3,0,1,2,0,215,6,221
2,SALTILLO,1030,12,0,0,0,97,0,3,1,0,1,0,0,0,114,4,118
2,SALTILLO,1031,30,0,0,0,259,1,10,0,1,0,0,0,0,301,10,311
2,SALTILLO,1032,17,0,0,0,73,1,0,0,0,0,0,0,0,91,2,93
2,SALTILLO,1033,19,0,0,0,155,2,1,1,1,0,2,9,0,190,10,200
2,SALTILLO,1034,8,0,0,0,99,0,0,0,0,0,0,0,0,107,7,114
2,SALTILLO,1035,17,0,0,0,116,3,2,0,2,0,0,0,0,140,2,142
2,SALTILLO,1036,11,0,0,0,110,1,5,0,0,0,0,0,0,127,7,134
2,SALTILLO,1037,7,0,0,0,40,0,1,0,0,0,0,0,0,48,1,49
2,SALTILLO,1038,18,0,0,0,200,0,2,1,1,0,0,1,0,223,11,234
2,SALTILLO,1039,45,0,0,0,214,3,3,2,0,0,0,1,0,268,8,276
13,SAN BUENAVENTURA,1040,245,0,0,0,507,5,4,6,2,1,15,2,0,787,13,800
13,SAN BUENAVENTURA,1041,264,0,0,0,449,9,3,4,3,12,0,9,0,753,12,765
13,SAN BUENAVENTURA,1042,317,0,0,0,430,7,8,2,6,24,2,11,0,807,10,817
13,SAN BUENAVENTURA,1043,258,0,0,0,478,6,14,1,1,15,7,6,1,787,168,955
13,SAN BUENAVENTURA,1044,319,0,0,0,376,8,6,5,1,14,3,4,5,741,18,759
13,SAN BUENAVENTURA,1045,215,0,0,0,231,6,3,3,3,12,1,4,0,478,11,489
13,SAN BUENAVENTURA,1046,280,0,0,0,379,6,4,6,1,21,8,2,5,712,9,721
13,SAN BUENAVENTURA,1047,353,0,0,0,549,6,9,4,5,17,5,12,3,963,23,986
13,SAN BUENAVENTURA,1048,395,0,0,0,614,11,15,8,4,14,17,8,2,1088,21,1109
13,SAN BUENAVENTURA,1049,189,0,0,0,510,5,6,5,1,3,3,3,3,728,12,740
13,SAN BUENAVENTURA,1050,189,0,0,0,289,2,3,4,6,10,7,3,0,513,9,522
13,SAN BUENAVENTURA,1051,230,0,0,0,478,7,4,1,2,14,5,4,3,748,16,764
13,SAN BUENAVENTURA,1052,295,0,0,0,351,3,7,2,4,5,5,3,0,675,15,690
13,SAN BUENAVENTURA,1054,66,0,0,0,108,0,2,2,2,0,0,1,0,181,2,183
13,SAN BUENAVENTURA,1055,93,0,0,0,183,2,4,1,1,0,1,1,0,286,10,296
13,SAN BUENAVENTURA,1056,88,0,0,0,159,0,2,1,0,3,0,1,0,254,7,261
13,SAN BUENAVENTURA,1057,85,0,0,0,170,1,3,2,0,0,5,2,1,269,5,274
13,SAN JUAN DE SABINAS,1058,276,0,0,0,270,9,11,6,2,5,3,2,0,584,19,603
13,SAN JUAN DE SABINAS,1059,169,0,0,0,171,14,5,4,1,5,0,1,0,370,8,378
13,SAN JUAN DE SABINAS,1060,333,0,0,0,405,40,24,6,5,1,3,3,4,824,45,869
13,SAN JUAN DE SABINAS,1061,329,0,0,0,316,27,2,10,1,7,2,1,6,701,12,713
13,SAN JUAN DE SABINAS,1062,278,0,0,0,424,11,5,4,1,4,0,0,4,731,18,749
13,SAN JUAN DE SABINAS,1063,310,0,0,0,350,16,3,5,1,8,1,0,0,694,18,712
13,SAN JUAN DE SABINAS,1064,311,0,0,0,466,21,6,8,3,8,0,3,2,828,24,852
13,SAN JUAN DE SABINAS,1065,189,0,0,0,282,8,5,8,3,4,2,0,3,504,16,520
13,SAN JUAN DE SABINAS,1066,208,0,0,0,301,18,4,9,4,4,0,2,2,552,11,563
13,SAN JUAN DE SABINAS,1067,439,0,0,0,452,11,8,11,2,3,0,1,4,931,13,944
13,SAN JUAN DE SABINAS,1068,286,0,0,0,395,22,2,5,1,3,3,1,1,719,14,733
13,SAN JUAN DE SABINAS,1069,176,0,0,0,229,3,3,3,6,1,1,1,3,426,10,436
13,SAN JUAN DE SABINAS,1070,94,0,0,0,138,3,2,0,2,7,0,0,0,246,6,252
13,SAN JUAN DE SABINAS,1071,365,0,0,0,515,14,10,5,2,6,2,2,3,924,23,947
13,SAN JUAN DE SABINAS,1072,251,0,0,0,293,17,0,6,1,9,0,1,5,583,12,595
13,SAN JUAN DE SABINAS,1073,326,0,0,0,366,14,3,13,2,9,0,0,6,739,14,753
13,SAN JUAN DE SABINAS,1074,201,0,0,0,232,8,4,4,1,3,1,1,1,456,15,471
13,SAN JUAN DE SABINAS,1075,150,0,0,0,214,10,2,7,2,1,1,0,0,387,7,394
13,SAN JUAN DE SABINAS,1076,298,0,0,0,343,19,2,7,2,9,0,3,0,683,25,708
13,SAN JUAN DE SABINAS,1077,164,0,0,0,232,14,4,3,2,3,1,1,0,424,10,434
13,SAN JUAN DE SABINAS,1078,611,0,0,0,520,54,3,9,6,15,2,11,2,1233,23,1256
13,SAN JUAN DE SABINAS,1079,268,0,0,0,299,35,4,7,1,15,2,0,9,640,8,648
13,SAN JUAN DE SABINAS,1080,225,0,0,0,220,20,2,4,3,15,1,1,3,494,11,505
13,SAN JUAN DE SABINAS,1081,191,0,0,0,170,17,3,6,2,5,0,0,0,394,9,403
13,SAN JUAN DE SABINAS,1082,447,0,0,0,359,27,6,3,3,5,2,0,4,856,17,873
13,SAN JUAN DE SABINAS,1083,307,0,0,0,367,26,1,0,1,6,0,0,1,709,6,715
13,SAN JUAN DE SABINAS,1084,231,0,0,0,289,23,2,5,0,2,0,4,1,557,4,561
13,SAN JUAN DE SABINAS,1085,260,0,0,0,286,46,3,5,5,12,0,2,3,622,8,630
13,SAN JUAN DE SABINAS,1086,201,0,0,0,290,18,5,3,3,8,0,2,1,531,11,542
13,SAN JUAN DE SABINAS,1087,251,0,0,0,291,10,8,6,4,5,1,0,0,576,24,600
13,SAN JUAN DE SABINAS,1088,462,0,0,0,529,57,1,7,10,11,1,2,196,1276,8,1284
13,SAN JUAN DE SABINAS,1089,138,0,0,0,200,4,1,3,3,0,0,1,2,352,18,370
13,SAN JUAN DE SABINAS,1090,182,0,0,0,232,5,1,4,1,2,1,0,1,429,9,438
10,SAN PEDRO,1091,636,0,0,0,790,36,18,6,26,38,5,30,3,1588,35,1623
10,SAN PEDRO,1092,107,0,0,0,209,8,5,2,9,0,1,2,0,343,11,354
10,SAN PEDRO,1093,339,0,0,0,435,21,14,4,20,11,5,14,5,868,33,901
10,SAN PEDRO,1094,460,0,0,0,506,32,20,11,19,11,12,10,4,1085,37,1122
10,SAN PEDRO,1095,273,0,0,0,329,23,11,4,13,7,3,7,0,670,21,691
10,SAN PEDRO,1096,313,0,0,0,488,21,7,7,18,9,2,6,2,873,23,896
10,SAN PEDRO,1097,228,0,0,0,555,18,15,7,15,16,3,14,0,871,30,901
10,SAN PEDRO,1098,378,0,0,0,629,25,16,2,14,20,5,22,0,1111,47,1158
10,SAN PEDRO,1099,174,0,0,0,300,6,7,7,22,12,3,12,6,549,11,560
10,SAN PEDRO,1100,306,0,0,0,500,15,16,9,41,4,3,13,4,911,21,932
10,SAN PEDRO,1101,121,0,0,0,224,6,5,2,27,5,0,7,1,398,1,399
10,SAN PEDRO,1102,113,0,0,0,170,11,10,5,25,7,2,11,2,356,22,378
10,SAN PEDRO,1103,214,0,0,0,379,21,11,3,23,12,2,11,3,679,35,714
10,SAN PEDRO,1104,280,0,0,0,445,22,9,8,15,21,8,15,9,832,33,865
10,SAN PEDRO,1105,171,0,0,0,344,33,8,4,9,11,2,14,4,600,18,618
10,SAN PEDRO,1106,258,0,0,0,239,6,10,2,17,10,7,12,1,562,26,588
10,SAN PEDRO,1107,90,0,0,0,125,11,5,0,22,3,2,6,1,265,12,277
10,SAN PEDRO,1108,194,0,0,0,338,16,4,10,27,9,3,21,0,622,26,648
10,SAN PEDRO,1109,325,0,0,0,538,39,13,9,46,15,2,21,4,1012,33,1045
10,SAN PEDRO,1110,182,0,0,0,354,18,11,4,38,28,7,16,2,660,17,677
10,SAN PEDRO,1111,258,0,0,0,486,49,11,9,18,21,4,10,8,874,27,901
10,SAN PEDRO,1112,164,0,0,0,331,18,10,7,13,11,3,10,2,569,16,585
10,SAN PEDRO,1113,200,0,0,0,339,26,3,4,12,7,6,32,2,631,25,656
10,SAN PEDRO,1114,70,0,0,0,155,15,3,2,4,2,1,6,0,258,9,267
10,SAN PEDRO,1115,352,0,0,0,552,20,11,7,26,21,5,9,3,1006,28,1034
10,SAN PEDRO,1116,265,0,0,0,583,61,10,4,11,11,10,3,8,966,24,990
10,SAN PEDRO,1117,207,0,0,0,406,72,12,5,10,9,3,7,1,732,41,773
10,SAN PEDRO,1118,380,0,0,0,510,55,12,9,19,14,4,6,7,1016,31,1047
10,SAN PEDRO,1119,40,0,0,0,143,2,1,2,1,1,0,0,0,190,3,193
10,SAN PEDRO,1120,58,0,0,0,118,4,6,0,1,1,0,1,0,189,5,194
10,SAN PEDRO,1121,86,0,0,0,93,4,1,3,0,1,0,1,0,189,4,193
10,SAN PEDRO,1122,229,0,0,0,213,6,4,0,11,0,1,11,0,475,10,485
10,SAN PEDRO,1123,6,0,0,0,57,3,0,0,0,2,1,0,0,69,3,72
10,SAN PEDRO,1124,15,0,0,0,56,2,0,0,0,0,0,0,0,73,1,74
10,SAN PEDRO,1125,476,0,0,0,362,12,6,3,4,0,2,4,2,871,19,890
10,SAN PEDRO,1126,107,0,0,0,113,2,0,1,1,0,0,3,0,227,1,228
10,SAN PEDRO,1127,167,0,0,0,228,9,1,2,1,0,0,0,0,408,7,415
10,SAN PEDRO,1128,287,0,0,0,296,7,2,2,0,7,0,10,10,621,4,625
10,SAN PEDRO,1129,224,0,0,0,412,12,4,9,13,4,4,14,2,698,15,713
10,SAN PEDRO,1130,248,0,0,0,337,8,7,5,3,9,2,3,0,622,15,637
10,SAN PEDRO,1131,285,0,0,0,457,10,0,1,3,2,0,4,0,762,17,779
10,SAN PEDRO,1132,419,0,0,0,556,39,9,5,3,9,2,0,1,1043,11,1054
10,SAN PEDRO,1133,95,0,0,0,269,4,5,1,0,2,0,1,0,377,4,381
10,SAN PEDRO,1134,65,0,0,0,75,9,2,1,2,8,1,4,1,168,9,177
10,SAN PEDRO,1135,265,0,0,0,261,21,9,11,9,5,3,5,0,589,12,601
10,SAN PEDRO,1136,216,0,0,0,500,14,8,9,7,89,6,21,2,872,19,891
10,SAN PEDRO,1137,219,0,0,0,544,23,12,6,2,69,2,22,1,900,23,923
10,SAN PEDRO,1138,173,0,0,0,384,12,7,2,6,8,5,10,0,607,14,621
10,SAN PEDRO,1139,309,0,0,0,290,20,3,5,0,5,6,15,2,655,16,671
10,SAN PEDRO,1140,379,0,0,0,508,42,12,6,7,20,12,28,1,1015,14,1029
10,SAN PEDRO,1141,392,0,0,0,439,32,12,24,4,4,4,52,1,964,26,990
10,SAN PEDRO,1142,385,0,0,0,492,27,16,22,2,8,6,93,0,1051,31,1082
10,SAN PEDRO,1143,115,0,0,0,148,19,8,2,6,6,3,1,4,312,4,316
10,SAN PEDRO,1144,119,0,0,0,191,8,4,1,2,7,2,4,0,338,10,348
10,SAN PEDRO,1145,37,0,0,0,45,7,0,1,4,2,8,4,0,108,1,109
10,SAN PEDRO,1146,263,0,0,0,467,14,0,5,1,6,2,1,0,759,10,769
10,SAN PEDRO,1147,265,0,0,0,263,20,7,16,6,2,5,0,1,585,17,602
10,SAN PEDRO,1148,214,0,0,0,336,28,17,6,50,2,6,5,0,664,21,685
10,SAN PEDRO,1149,313,0,0,0,795,16,16,6,6,9,3,5,2,1171,19,1190
10,SAN PEDRO,1150,171,0,0,0,163,4,3,0,1,0,0,1,0,343,18,361
10,SAN PEDRO,1151,238,0,0,0,286,5,3,1,9,6,4,3,5,560,14,574
10,SAN PEDRO,1152,96,0,0,0,117,6,3,1,22,1,7,7,0,260,5,265
10,SAN PEDRO,1153,195,0,0,0,238,16,4,0,5,5,2,2,0,467,14,481
10,SAN PEDRO,1154,238,0,0,0,246,11,7,2,7,15,6,5,3,540,7,547
10,SAN PEDRO,1155,208,0,0,0,247,9,7,2,6,3,1,3,1,487,13,500
10,SAN PEDRO,1156,418,0,0,0,379,17,5,0,3,7,2,3,0,834,28,862
10,SAN PEDRO,1157,376,0,0,0,571,31,13,9,35,7,4,11,1,1058,32,1090
10,SAN PEDRO,1158,220,0,0,0,264,9,11,1,1,10,2,8,0,526,12,538
10,SAN PEDRO,1159,269,0,0,0,328,20,16,3,7,15,4,4,3,669,20,689
10,SAN PEDRO,1160,266,0,0,0,230,9,14,2,8,9,2,8,5,553,22,575
10,SAN PEDRO,1161,362,0,0,0,489,13,6,4,2,7,4,5,1,893,20,913
10,SAN PEDRO,1162,272,0,0,0,378,40,29,4,5,14,7,54,0,803,33,836
10,SAN PEDRO,1163,376,0,0,0,518,45,5,2,24,7,5,21,0,1003,18,1021
10,SAN PEDRO,1164,70,0,0,0,196,7,2,0,12,5,4,19,1,316,15,331
10,SAN PEDRO,1165,91,0,0,0,130,5,5,1,0,2,2,2,1,239,3,242
10,SIERRA MOJADA,1166,21,0,0,0,164,3,2,0,0,2,1,21,0,214,7,221
10,SIERRA MOJADA,1167,139,0,0,0,639,8,5,3,0,2,2,11,2,811,22,833
10,SIERRA MOJADA,1168,12,0,0,0,90,1,0,4,0,0,0,0,0,107,4,111
10,SIERRA MOJADA,1169,1,0,0,0,32,0,1,0,0,0,0,1,0,35,0,35
10,SIERRA MOJADA,1170,101,0,0,0,329,2,1,3,1,2,1,25,3,468,16,484
10,SIERRA MOJADA,1171,19,0,0,0,162,0,0,0,0,0,0,0,0,181,9,190
9,TORREON,1172,386,0,0,272,0,7,9,5,9,0,6,0,0,694,23,717
9,TORREON,1173,441,0,0,503,0,9,14,9,7,0,4,0,0,987,31,1018
9,TORREON,1174,226,0,0,222,0,12,10,4,0,0,0,0,0,474,10,484
9,TORREON,1175,215,0,0,340,0,8,10,5,1,0,2,0,0,581,19,600
9,TORREON,1176,429,0,0,477,0,19,21,5,7,0,3,0,0,961,42,1003
9,TORREON,1177,722,0,0,537,0,12,15,19,12,0,7,0,0,1324,57,1381
9,TORREON,1178,280,0,0,277,0,9,5,4,5,0,0,0,0,580,11,591
9,TORREON,1179,401,0,0,655,0,6,15,15,4,0,5,0,0,1101,27,1128
9,TORREON,1180,980,0,0,1368,0,19,19,24,10,0,9,0,0,2429,69,2498
9,TORREON,1181,243,0,0,389,0,8,10,10,6,0,5,0,0,671,15,686
9,TORREON,1182,203,0,0,366,0,10,10,10,8,0,2,0,0,609,22,631
9,TORREON,1183,770,0,0,310,0,12,19,18,19,0,3,0,0,1151,60,1211
9,TORREON,1184,1415,0,0,1579,0,183,49,46,12,0,4,0,0,3288,92,3380
9,TORREON,1185,249,0,0,515,0,7,14,12,4,0,4,0,0,805,22,827
9,TORREON,1186,160,0,0,330,0,6,8,1,2,0,1,0,0,508,7,515
9,TORREON,1187,434,0,0,212,0,12,10,9,7,0,12,0,0,696,21,717
9,TORREON,1188,314,0,0,309,0,11,7,12,4,0,4,0,0,661,21,682
9,TORREON,1189,202,0,0,492,0,5,9,10,6,0,7,0,0,731,21,752
9,TORREON,1190,197,0,0,559,0,11,5,11,2,0,3,0,0,788,21,809
9,TORREON,1191,212,0,0,322,0,7,9,10,5,0,0,0,0,565,9,574
9,TORREON,1192,326,0,0,390,0,6,12,11,5,0,2,0,0,752,18,770
9,TORREON,1193,614,0,0,526,0,28,19,16,5,0,12,0,0,1220,41,1261
9,TORREON,1194,334,0,0,397,0,19,5,12,2,0,3,0,0,772,26,798
9,TORREON,1195,288,0,0,422,0,20,10,8,5,0,13,0,0,766,31,797
9,TORREON,1196,306,0,0,404,0,5,11,7,6,0,4,0,0,743,19,762
9,TORREON,1197,322,0,0,492,0,8,13,10,1,0,7,0,0,853,26,879
9,TORREON,1198,192,0,0,427,0,8,7,10,4,0,7,0,0,655,18,673
9,TORREON,1199,278,0,0,375,0,10,3,18,4,0,11,0,0,699,27,726
9,TORREON,1200,582,0,0,138,0,1,12,7,14,0,19,0,0,773,43,816
9,TORREON,1201,274,0,0,426,0,10,10,10,4,0,7,0,0,741,34,775
9,TORREON,1202,209,0,0,481,0,5,9,15,5,0,2,0,0,726,21,747
9,TORREON,1203,274,0,0,309,0,10,12,16,13,0,6,0,0,640,27,667
9,TORREON,1204,448,0,0,236,0,10,10,11,7,0,17,0,0,739,36,775
9,TORREON,1205,424,0,0,210,0,12,5,10,3,0,26,0,0,690,22,712
9,TORREON,1206,445,0,0,233,0,12,14,11,19,0,12,0,0,746,34,780
9,TORREON,1207,585,0,0,157,0,11,5,15,6,0,5,0,0,784,45,829
9,TORREON,1208,268,0,0,386,0,15,15,13,3,0,6,0,0,706,21,727
9,TORREON,1209,358,0,0,493,0,11,10,20,5,0,2,0,0,899,23,922
9,TORREON,1210,363,0,0,475,0,11,17,8,7,0,4,0,0,885,32,917
9,TORREON,1211,154,0,0,254,0,8,8,11,5,0,7,0,0,447,12,459
9,TORREON,1212,151,0,0,271,0,5,4,6,4,0,32,0,0,473,9,482
9,TORREON,1213,367,0,0,429,0,17,16,12,2,0,4,0,0,847,34,881
9,TORREON,1214,460,0,0,396,0,17,21,20,10,0,11,0,0,935,40,975
9,TORREON,1215,464,0,0,277,0,13,6,16,6,0,14,0,0,796,35,831
9,TORREON,1216,228,0,0,234,0,9,10,11,5,0,3,0,0,500,25,525
9,TORREON,1217,263,0,0,105,0,4,8,11,10,0,9,0,0,410,18,428
8,TORREON,1218,590,213,0,0,0,18,12,0,7,0,3,0,0,843,41,884
8,TORREON,1219,447,110,0,0,0,7,5,0,1,0,4,0,0,574,15,589
8,TORREON,1220,239,387,0,0,0,9,7,0,7,0,0,0,0,649,12,661
8,TORREON,1221,232,388,0,0,0,8,9,0,19,0,0,0,0,656,19,675
8,TORREON,1222,298,281,0,0,0,10,9,0,4,0,3,0,0,605,15,620
8,TORREON,1223,187,316,0,0,0,3,5,0,6,0,5,0,0,522,14,536
8,TORREON,1224,249,381,0,0,0,6,9,0,4,0,5,0,0,654,23,677
8,TORREON,1225,173,300,0,0,0,5,10,0,6,0,6,0,0,500,12,512
8,TORREON,1226,130,220,0,0,0,6,8,0,0,0,0,0,0,364,7,371
8,TORREON,1227,507,191,0,0,0,13,15,0,6,0,5,0,0,737,40,777
8,TORREON,1228,459,171,0,0,0,12,12,0,5,0,2,0,0,661,33,694
8,TORREON,1229,144,308,0,0,0,6,4,0,7,0,2,0,0,471,9,480
8,TORREON,1230,141,333,0,0,0,10,9,0,7,0,1,0,0,501,13,514
8,TORREON,1231,149,201,0,0,0,12,9,0,5,0,1,0,0,377,11,388
8,TORREON,1232,387,156,0,0,0,6,18,0,9,0,3,0,0,579,31,610
8,TORREON,1233,388,203,0,0,0,11,6,0,6,0,2,0,0,616,31,647
8,TORREON,1234,193,186,0,0,0,10,15,0,4,0,2,0,0,410,10,420
8,TORREON,1235,179,184,0,0,0,2,13,0,15,0,2,0,0,395,17,412
8,TORREON,1236,163,168,0,0,0,5,16,0,3,0,2,0,0,357,20,377
8,TORREON,1237,171,207,0,0,0,5,3,0,4,0,2,0,0,392,21,413
8,TORREON,1238,158,190,0,0,0,6,4,0,2,0,6,0,0,366,14,380
8,TORREON,1239,195,176,0,0,0,12,9,0,9,0,2,0,0,403,16,419
8,TORREON,1240,165,296,0,0,0,5,5,0,8,0,2,0,0,481,18,499
8,TORREON,1241,191,189,0,0,0,13,15,0,3,0,4,0,0,415,17,432
8,TORREON,1242,250,270,0,0,0,7,9,0,5,0,2,0,0,543,15,558
8,TORREON,1243,190,193,0,0,0,9,7,0,2,0,2,0,0,403,16,419
8,TORREON,1244,135,185,0,0,0,3,4,0,2,0,2,0,0,331,18,349
8,TORREON,1245,147,310,0,0,0,3,15,0,3,0,0,0,0,478,19,497
8,TORREON,1246,137,216,0,0,0,13,7,0,6,0,6,0,0,385,18,403
8,TORREON,1247,229,410,0,0,0,13,10,0,3,0,3,0,0,668,16,684
8,TORREON,1248,244,434,0,0,0,13,9,0,8,0,1,0,0,709,23,732
8,TORREON,1249,160,251,0,0,0,6,5,0,7,0,0,0,0,429,14,443
8,TORREON,1250,182,300,0,0,0,9,9,0,15,0,2,0,0,517,8,525
8,TORREON,1251,83,255,0,0,0,3,3,0,2,0,0,0,0,346,6,352
8,TORREON,1252,104,336,0,0,0,6,4,0,3,0,2,0,0,455,19,474
8,TORREON,1253,159,340,0,0,0,6,8,0,0,0,1,0,0,514,13,527
8,TORREON,1254,213,397,0,0,0,8,7,0,4,0,2,0,0,631,20,651
8,TORREON,1255,152,224,0,0,0,6,9,0,2,0,1,0,0,394,8,402
8,TORREON,1256,106,224,0,0,0,6,9,0,0,0,2,0,0,347,23,370
8,TORREON,1257,191,506,0,0,0,12,14,0,9,0,2,0,0,734,13,747
8,TORREON,1258,233,587,0,0,0,8,13,0,9,0,3,0,0,853,20,873
8,TORREON,1259,199,418,0,0,0,11,10,0,10,0,8,0,0,656,28,684
8,TORREON,1260,11,10,0,0,0,0,0,0,0,0,0,0,0,21,2,23
8,TORREON,1261,257,672,0,0,0,8,9,0,5,0,4,0,0,955,32,987
8,TORREON,1262,87,345,0,0,0,6,5,0,3,0,0,0,0,446,6,452
8,TORREON,1263,102,353,0,0,0,2,5,0,4,0,2,0,0,468,9,477
8,TORREON,1264,188,567,0,0,0,6,10,0,8,0,4,0,0,783,20,803
8,TORREON,1265,110,339,0,0,0,0,6,0,5,0,1,0,0,461,12,473
8,TORREON,1266,244,691,0,0,0,16,6,0,8,0,2,0,0,967,44,1011
8,TORREON,1267,158,525,0,0,0,19,2,0,8,0,3,0,0,715,27,742
8,TORREON,1268,104,161,0,0,0,5,7,0,1,0,0,0,0,278,7,285
8,TORREON,1269,76,358,0,0,0,7,9,0,2,0,1,0,0,453,4,457
8,TORREON,1270,77,413,0,0,0,6,9,0,0,0,0,0,0,505,10,515
8,TORREON,1271,169,542,0,0,0,8,10,0,7,0,2,0,0,738,24,762
8,TORREON,1272,78,482,0,0,0,7,5,0,2,0,1,0,0,575,6,581
8,TORREON,1273,162,354,0,0,0,5,7,0,3,0,2,0,0,533,7,540
8,TORREON,1274,130,447,0,0,0,5,4,0,1,0,4,0,0,591,6,597
8,TORREON,1275,192,380,0,0,0,5,16,0,2,0,4,0,0,599,23,622
8,TORREON,1276,167,491,0,0,0,15,17,0,8,0,1,0,0,699,18,717
8,TORREON,1277,134,457,0,0,0,5,11,0,2,0,6,0,0,615,21,636
8,TORREON,1278,85,420,0,0,0,6,1,0,0,0,2,0,0,514,18,532
8,TORREON,1279,71,298,0,0,0,5,1,0,5,0,0,0,0,380,15,395
8,TORREON,1280,44,263,0,0,0,2,4,0,1,0,0,0,0,314,7,321
8,TORREON,1281,43,202,0,0,0,3,3,0,5,0,0,0,0,256,11,267
8,TORREON,1282,107,242,0,0,0,2,1,0,5,0,1,0,0,358,17,375
8,TORREON,1283,151,413,0,0,0,11,5,0,4,0,0,0,0,584,23,607
8,TORREON,1284,47,221,0,0,0,1,5,0,1,0,3,0,0,278,6,284
8,TORREON,1285,124,344,0,0,0,8,3,0,1,0,4,0,0,484,12,496
8,TORREON,1286,83,212,0,0,0,3,4,0,0,0,0,0,0,302,6,308
8,TORREON,1287,106,354,0,0,0,8,11,0,4,0,2,0,0,485,15,500
8,TORREON,1288,12,167,0,0,0,3,2,0,0,0,0,0,0,184,0,184
8,TORREON,1289,0,158,0,0,0,0,3,0,3,0,2,0,0,166,6,172
8,TORREON,1290,58,217,0,0,0,5,6,0,0,0,1,0,0,287,7,294
8,TORREON,1291,87,373,0,0,0,7,4,0,6,0,2,0,0,479,16,495
8,TORREON,1292,75,280,0,0,0,6,5,0,2,0,1,0,0,369,8,377
8,TORREON,1293,46,225,0,0,0,2,3,0,5,0,0,0,0,281,10,291
8,TORREON,1294,54,477,0,0,0,4,3,0,1,0,0,0,0,539,9,548
8,TORREON,1295,46,365,0,0,0,8,2,0,3,0,1,0,0,425,7,432
8,TORREON,1296,55,340,0,0,0,3,4,0,1,0,2,0,0,405,3,408
8,TORREON,1297,65,250,0,0,0,6,1,0,1,0,0,0,0,323,7,330
8,TORREON,1298,88,355,0,0,0,4,5,0,1,0,1,0,0,454,11,465
8,TORREON,1299,57,315,0,0,0,2,4,0,2,0,2,0,0,382,14,396
8,TORREON,1300,85,336,0,0,0,2,10,0,5,0,1,0,0,439,27,466
8,TORREON,1301,53,302,0,0,0,7,4,0,3,0,0,0,0,369,12,381
8,TORREON,1302,94,315,0,0,0,4,4,0,4,0,1,0,0,422,9,431
8,TORREON,1303,51,298,0,0,0,1,1,0,3,0,0,0,0,354,6,360
8,TORREON,1304,56,272,0,0,0,2,3,0,3,0,1,0,0,337,14,351
8,TORREON,1305,34,187,0,0,0,0,3,0,0,0,3,0,0,227,3,230
8,TORREON,1306,113,316,0,0,0,4,6,0,7,0,4,0,0,450,19,469
8,TORREON,1307,72,353,0,0,0,3,6,0,1,0,0,0,0,435,22,457
8,TORREON,1308,72,328,0,0,0,5,3,0,8,0,1,0,0,417,8,425
8,TORREON,1309,88,724,0,0,0,9,12,0,2,0,0,0,0,835,11,846
9,TORREON,1310,1692,0,0,2715,0,66,63,71,27,0,19,0,0,4653,105,4758
9,TORREON,1311,236,0,0,358,0,21,6,12,8,0,1,0,0,642,21,663
9,TORREON,1312,275,0,0,378,0,26,16,16,7,0,6,0,0,724,21,745
6,TORREON,1313,265,0,409,0,0,15,16,15,4,0,0,15,0,739,29,768
6,TORREON,1314,2037,0,3855,0,0,94,76,110,41,0,0,175,0,6388,171,6559
9,TORREON,1315,261,0,0,445,0,12,15,15,3,0,1,0,0,752,20,772
9,TORREON,1316,192,0,0,306,0,17,13,15,3,0,0,0,0,546,15,561
9,TORREON,1317,326,0,0,374,0,26,9,17,7,0,3,0,0,762,26,788
9,TORREON,1318,230,0,0,464,0,16,11,14,6,0,1,0,0,742,17,759
9,TORREON,1319,194,0,0,387,0,22,9,11,4,0,1,0,0,628,23,651
9,TORREON,1320,785,0,0,1201,0,132,29,29,10,0,8,0,0,2194,65,2259
9,TORREON,1321,186,0,0,324,0,8,6,8,2,0,0,0,0,534,10,544
9,TORREON,1322,400,0,0,584,0,26,22,10,8,0,5,0,0,1055,35,1090
9,TORREON,1323,248,0,0,590,0,11,18,12,4,0,1,0,0,884,23,907
9,TORREON,1324,187,0,0,468,0,8,11,14,2,0,0,0,0,690,20,710
9,TORREON,1325,176,0,0,405,0,11,11,11,6,0,4,0,0,624,23,647
9,TORREON,1326,237,0,0,408,0,15,14,33,2,0,4,0,0,713,19,732
9,TORREON,1327,176,0,0,452,0,13,9,8,4,0,2,0,0,664,21,685
9,TORREON,1328,271,0,0,335,0,5,11,12,3,0,1,0,0,638,15,653
9,TORREON,1329,195,0,0,564,0,10,12,19,1,0,1,0,0,802,31,833
9,TORREON,1330,194,0,0,417,0,18,12,9,1,0,1,0,0,652,14,666
9,TORREON,1331,213,0,0,339,0,6,13,4,1,0,1,0,0,577,11,588
8,TORREON,1332,217,471,0,0,0,16,11,0,9,0,13,0,0,737,17,754
8,TORREON,1333,214,327,0,0,0,10,13,0,7,0,4,0,0,575,26,601
8,TORREON,1334,184,269,0,0,0,10,8,0,9,0,3,0,0,483,15,498
8,TORREON,1335,129,170,0,0,0,9,5,0,4,0,0,0,0,317,9,326
8,TORREON,1336,174,492,0,0,0,8,9,0,3,0,2,0,0,688,20,708
8,TORREON,1337,152,399,0,0,0,5,9,0,3,0,2,0,0,570,15,585
8,TORREON,1338,191,481,0,0,0,18,12,0,2,0,4,0,0,708,23,731
8,TORREON,1339,279,382,0,0,0,14,20,0,7,0,2,0,0,704,21,725
8,TORREON,1340,186,482,0,0,0,12,9,0,6,0,1,0,0,696,18,714
8,TORREON,1341,189,442,0,0,0,9,7,0,4,0,11,0,0,662,14,676
9,TORREON,1342,230,0,0,404,0,10,6,11,4,0,1,0,0,666,16,682
9,TORREON,1343,246,0,0,628,0,10,16,5,2,0,0,0,0,907,16,923
9,TORREON,1344,93,0,0,461,0,3,5,11,0,0,0,0,0,573,18,591
9,TORREON,1345,196,0,0,530,0,4,20,7,3,0,1,0,0,761,9,770
9,TORREON,1346,229,0,0,480,0,7,17,10,3,0,2,0,0,748,17,765
9,TORREON,1347,144,0,0,467,0,19,5,12,5,0,4,0,0,656,26,682
9,TORREON,1348,223,0,0,464,0,16,15,13,2,0,1,0,0,734,21,755
9,TORREON,1349,245,0,0,469,0,16,17,14,9,0,2,0,0,772,15,787
9,TORREON,1350,2342,0,0,3029,0,141,103,113,47,0,15,0,0,5790,195,5985
9,TORREON,1351,2297,0,0,3303,0,128,96,97,40,0,17,0,0,5978,169,6147
7,TORREON,1352,369,0,0,0,531,24,19,8,7,7,8,10,5,988,29,1017
7,TORREON,1353,390,0,0,0,549,15,22,8,4,5,0,3,1,997,18,1015
7,TORREON,1354,1712,0,0,0,2774,60,57,41,25,66,10,13,17,4775,76,4851
7,TORREON,1355,275,0,0,0,498,5,11,6,2,3,1,3,3,807,15,822
7,TORREON,1356,263,0,0,0,355,5,3,3,1,10,1,2,0,643,10,653
7,TORREON,1357,177,0,0,0,332,11,5,3,1,6,0,3,0,538,8,546
7,TORREON,1358,246,0,0,0,461,7,5,9,3,7,1,3,3,745,22,767
7,TORREON,1359,413,0,0,0,669,13,9,9,5,3,1,3,1,1126,23,1149
7,TORREON,1360,2777,0,0,0,2688,64,98,57,30,39,10,20,16,5799,183,5982
7,TORREON,1361,450,0,0,0,701,13,21,9,4,3,2,5,3,1211,28,1239
7,TORREON,1362,373,0,0,0,426,18,12,11,2,9,3,1,5,860,27,887
7,TORREON,1363,273,0,0,0,588,8,6,7,4,3,1,1,2,893,15,908
7,TORREON,1364,277,0,0,0,343,4,5,5,2,4,0,1,0,641,13,654
9,TORREON,1365,1239,0,0,1991,0,95,80,65,27,0,11,0,0,3508,122,3630
9,TORREON,1366,258,0,0,286,0,19,12,8,2,0,3,0,0,588,26,614
9,TORREON,1367,341,0,0,507,0,22,14,9,4,0,2,0,0,899,28,927
8,TORREON,1368,339,400,0,0,0,12,13,0,5,0,3,0,0,772,28,800
8,TORREON,1369,237,316,0,0,0,8,15,0,9,0,5,0,0,590,18,608
8,TORREON,1370,163,184,0,0,0,7,3,0,7,0,1,0,0,365,18,383
8,TORREON,1371,147,272,0,0,0,12,13,0,3,0,1,0,0,448,14,462
8,TORREON,1372,189,258,0,0,0,4,10,0,5,0,0,0,0,466,14,480
8,TORREON,1373,210,277,0,0,0,9,21,0,3,0,0,0,0,520,18,538
8,TORREON,1374,295,307,0,0,0,16,9,0,9,0,4,0,0,640,40,680
8,TORREON,1375,196,319,0,0,0,9,9,0,8,0,0,0,0,541,12,553
8,TORREON,1376,319,276,0,0,0,13,15,0,5,0,1,0,0,629,27,656
8,TORREON,1377,298,396,0,0,0,19,13,0,5,0,2,0,0,733,21,754
8,TORREON,1378,205,340,0,0,0,12,7,0,4,0,4,0,0,572,26,598
8,TORREON,1379,197,187,0,0,0,3,13,0,6,0,4,0,0,410,10,420
9,TORREON,1380,393,0,0,321,0,15,10,13,6,0,1,0,0,759,31,790
9,TORREON,1381,298,0,0,287,0,5,12,12,2,0,2,0,0,618,22,640
7,TORREON,1382,1039,0,0,0,1104,42,48,21,9,20,4,9,10,2306,77,2383
7,TORREON,1383,278,0,0,0,675,9,16,8,4,3,2,3,8,1006,30,1036
7,TORREON,1384,498,0,0,0,724,18,18,11,4,6,0,1,5,1285,23,1308
7,TORREON,1385,201,0,0,0,266,6,15,4,0,4,0,0,136,632,13,645
7,TORREON,1386,282,0,0,0,485,8,12,8,6,9,4,0,4,818,15,833
7,TORREON,1387,164,0,0,0,456,10,9,5,5,1,1,2,0,653,24,677
7,TORREON,1388,1000,0,0,0,672,27,34,18,9,20,0,10,3,1793,61,1854
7,TORREON,1389,198,0,0,0,302,10,8,3,1,11,1,3,1,538,10,548
7,TORREON,1390,271,0,0,0,412,21,14,5,3,10,3,3,4,746,8,754
7,TORREON,1391,597,0,0,0,226,4,11,9,1,6,1,0,6,861,37,898
8,TORREON,1392,479,171,0,0,0,7,12,0,5,0,2,0,0,676,39,715
8,TORREON,1393,621,189,0,0,0,5,8,0,8,0,4,0,0,835,42,877
8,TORREON,1394,164,176,0,0,0,6,5,0,1,0,3,0,0,355,16,371
8,TORREON,1395,458,231,0,0,0,7,14,0,2,0,1,0,0,713,33,746
8,TORREON,1396,104,212,0,0,0,2,12,0,5,0,3,0,0,338,15,353
8,TORREON,1397,186,444,0,0,0,6,24,0,6,0,10,0,0,676,32,708
8,TORREON,1398,504,346,0,0,0,8,18,0,11,0,2,0,0,889,29,918
8,TORREON,1399,357,306,0,0,0,13,14,0,7,0,3,0,0,700,33,733
8,TORREON,1400,380,140,0,0,0,10,7,0,3,0,4,0,0,544,23,567
8,TORREON,1401,389,174,0,0,0,12,15,0,7,0,1,0,0,598,36,634
8,TORREON,1402,548,194,0,0,0,9,21,0,4,0,5,0,0,781,47,828
7,TORREON,1403,601,0,0,0,264,6,9,14,3,2,4,1,4,908,32,940
7,TORREON,1404,431,0,0,0,197,5,9,12,1,2,1,0,1,659,24,683
7,TORREON,1405,504,0,0,0,206,18,12,4,5,0,0,3,4,756,33,789
7,TORREON,1406,576,0,0,0,235,7,22,2,4,8,2,1,2,859,30,889
7,TORREON,1407,812,0,0,0,520,21,16,16,14,17,2,8,1,1427,47,1474
7,TORREON,1408,449,0,0,0,271,6,14,3,1,6,1,3,1,755,31,786
7,TORREON,1410,312,0,0,0,660,12,9,9,0,6,3,7,1,1019,17,1036
7,TORREON,1412,333,0,0,0,519,12,17,5,0,3,3,3,2,897,28,925
7,TORREON,1413,348,0,0,0,345,5,6,6,3,3,5,1,4,726,24,750
7,TORREON,1414,327,0,0,0,516,14,7,17,1,2,6,3,3,896,28,924
7,TORREON,1415,277,0,0,0,354,10,7,8,4,11,2,1,4,678,18,696
7,TORREON,1416,264,0,0,0,313,6,13,8,4,5,2,1,3,619,17,636
7,TORREON,1417,363,0,0,0,279,8,14,7,2,8,1,6,1,689,25,714
7,TORREON,1418,353,0,0,0,352,11,12,1,4,7,1,0,4,745,26,771
7,TORREON,1419,273,0,0,0,264,2,9,4,3,6,1,2,1,565,16,581
7,TORREON,1420,430,0,0,0,309,9,7,4,8,4,3,2,0,776,17,793
7,TORREON,1421,209,0,0,0,338,11,5,5,11,7,0,3,3,592,24,616
7,TORREON,1422,283,0,0,0,316,7,7,2,3,10,3,2,2,635,17,652
7,TORREON,1423,432,0,0,0,328,9,13,4,4,3,2,1,1,797,25,822
8,TORREON,1424,241,348,0,0,0,9,6,0,4,0,2,0,0,610,20,630
8,TORREON,1425,212,529,0,0,0,8,21,0,9,0,7,0,0,786,21,807
8,TORREON,1426,94,502,0,0,0,7,13,0,5,0,2,0,0,623,29,652
8,TORREON,1427,181,513,0,0,0,9,13,0,7,0,4,0,0,727,19,746
8,TORREON,1428,192,398,0,0,0,11,15,0,9,0,4,0,0,629,19,648
8,TORREON,1429,209,506,0,0,0,17,13,0,5,0,3,0,0,753,20,773
8,TORREON,1430,268,617,0,0,0,21,19,0,4,0,7,0,0,936,16,952
8,TORREON,1431,164,413,0,0,0,7,7,0,3,0,2,0,0,596,19,615
8,TORREON,1432,161,442,0,0,0,13,6,0,5,0,2,0,0,629,24,653
8,TORREON,1433,181,479,0,0,0,6,13,0,5,0,0,0,0,684,9,693
8,TORREON,1434,217,331,0,0,0,8,22,0,3,0,4,0,0,585,27,612
8,TORREON,1435,124,302,0,0,0,7,5,0,3,0,2,0,0,443,20,463
7,TORREON,1436,21,0,0,0,63,0,0,0,0,0,0,0,0,84,2,86
7,TORREON,1437,87,0,0,0,234,3,5,2,3,1,0,1,0,336,7,343
7,TORREON,1438,132,0,0,0,368,4,1,6,1,2,1,3,0,518,7,525
7,TORREON,1439,142,0,0,0,426,6,5,2,0,1,1,1,0,584,10,594
7,TORREON,1440,138,0,0,0,336,4,6,1,0,1,0,1,1,488,9,497
7,TORREON,1441,112,0,0,0,273,6,5,2,3,0,0,2,0,403,14,417
7,TORREON,1442,262,0,0,0,489,7,12,6,3,2,3,2,0,786,17,803
7,TORREON,1443,105,0,0,0,338,2,3,3,1,2,0,0,0,454,9,463
7,TORREON,1444,132,0,0,0,424,3,4,10,2,0,4,6,2,587,20,607
7,TORREON,1445,384,0,0,0,959,7,25,11,4,1,1,7,0,1399,27,1426
7,TORREON,1446,289,0,0,0,565,8,13,8,2,3,6,8,0,902,29,931
7,TORREON,1447,195,0,0,0,397,4,8,5,1,9,0,2,0,621,17,638
7,TORREON,1448,215,0,0,0,310,6,7,5,5,3,1,1,0,553,10,563
7,TORREON,1449,250,0,0,0,712,11,11,10,4,6,2,6,1,1013,43,1056
7,TORREON,1450,189,0,0,0,385,2,8,4,0,6,1,0,3,598,17,615
7,TORREON,1451,308,0,0,0,508,9,9,5,2,3,2,4,0,850,21,871
7,TORREON,1452,212,0,0,0,453,6,14,7,3,1,1,0,4,701,16,717
7,TORREON,1453,235,0,0,0,434,8,9,8,1,5,0,0,1,701,15,716
7,TORREON,1454,241,0,0,0,419,6,6,3,3,4,1,0,0,683,12,695
7,TORREON,1455,220,0,0,0,465,8,4,9,1,8,3,3,0,721,13,734
7,TORREON,1456,403,0,0,0,1169,15,18,17,4,13,9,5,7,1660,48,1708
7,TORREON,1457,79,0,0,0,196,4,2,4,0,1,2,0,3,291,5,296
7,TORREON,1458,60,0,0,0,210,3,0,1,1,1,0,3,0,279,8,287
6,TORREON,1459,550,0,487,0,0,11,10,9,6,0,0,11,0,1084,21,1105
6,TORREON,1460,464,0,660,0,0,16,12,8,5,0,0,63,0,1228,54,1282
6,TORREON,1461,879,0,652,0,0,19,23,11,9,0,0,57,0,1650,70,1720
6,TORREON,1462,715,0,670,0,0,28,19,11,12,0,0,36,0,1491,36,1527
6,TORREON,1463,316,0,612,0,0,24,15,8,9,0,0,20,0,1004,28,1032
6,TORREON,1464,521,0,602,0,0,25,20,16,21,0,0,12,0,1217,41,1258
6,TORREON,1465,512,0,469,0,0,9,9,8,5,0,0,68,0,1080,33,1113
6,TORREON,1466,729,0,1146,0,0,12,20,17,10,0,0,88,0,2022,72,2094
6,TORREON,1467,456,0,656,0,0,17,14,9,8,0,0,68,0,1228,51,1279
6,TORREON,1468,191,0,457,0,0,7,6,5,1,0,0,6,0,673,19,692
6,TORREON,1469,1897,0,2803,0,0,83,46,52,22,0,0,58,0,4961,141,5102
6,TORREON,1470,167,0,572,0,0,8,10,8,6,0,0,2,0,773,27,800
6,TORREON,1471,81,0,204,0,0,4,5,4,4,0,0,1,0,303,11,314
6,TORREON,1472,155,0,174,0,0,8,2,5,3,0,0,11,0,358,14,372
6,TORREON,1473,127,0,236,0,0,8,8,8,1,0,0,2,0,390,20,410
6,TORREON,1474,49,0,104,0,0,1,2,1,0,0,0,0,0,157,8,165
6,VIESCA,1475,244,0,533,0,0,7,12,5,6,0,0,29,0,836,23,859
6,VIESCA,1476,275,0,601,0,0,10,13,6,7,0,0,46,0,958,42,1000
6,VIESCA,1477,55,0,132,0,0,4,9,1,2,0,0,31,0,234,13,247
6,VIESCA,1478,155,0,160,0,0,25,2,2,4,0,0,111,0,459,7,466
6,VIESCA,1479,148,0,233,0,0,55,5,1,5,0,0,38,0,485,19,504
6,VIESCA,1480,122,0,0,0,0,7,3,0,2,0,0,17,0,151,9,160
6,VIESCA,1481,102,0,143,0,0,2,7,0,3,0,0,30,0,287,6,293
6,VIESCA,1482,64,0,198,0,0,1,3,0,2,0,0,20,0,288,10,298
6,VIESCA,1483,48,0,146,0,0,9,25,0,0,0,0,6,0,234,5,239
6,VIESCA,1484,241,0,366,0,0,9,5,4,1,0,0,48,0,674,11,685
6,VIESCA,1485,192,0,348,0,0,8,6,8,4,0,0,24,0,590,21,611
6,VIESCA,1486,13,0,175,0,0,3,2,0,1,0,0,0,0,194,6,200
6,VIESCA,1488,21,0,89,0,0,0,2,0,0,0,0,4,0,116,1,117
6,VIESCA,1489,227,0,204,0,0,1,14,4,4,0,0,26,0,480,16,496
6,VIESCA,1490,77,0,768,0,0,7,8,6,1,0,0,15,0,882,47,929
6,VIESCA,1491,167,0,544,0,0,45,11,5,5,0,0,123,0,900,49,949
6,VIESCA,1492,139,0,257,0,0,70,7,6,0,0,0,168,0,647,23,670
6,VIESCA,1493,106,0,245,0,0,32,1,4,2,0,0,60,0,450,28,478
6,VIESCA,1494,4,0,96,0,0,0,0,0,0,0,0,0,0,100,2,102
6,VIESCA,1495,1,0,68,0,0,0,0,0,0,0,0,0,0,69,2,71
6,VIESCA,1496,40,0,71,0,0,2,2,2,2,0,0,1,0,120,4,124
6,VIESCA,1497,18,0,251,0,0,2,1,3,1,0,0,0,0,276,13,289
14,VILLA UNION,1498,174,0,185,0,0,2,3,1,5,0,0,0,0,370,12,382
14,VILLA UNION,1499,225,0,251,0,0,4,1,2,1,0,0,0,0,484,15,499
14,VILLA UNION,1500,271,0,306,0,0,1,6,4,4,0,0,0,0,592,23,615
14,VILLA UNION,1501,190,0,248,0,0,8,3,3,4,0,0,0,0,456,20,476
14,VILLA UNION,1502,304,0,381,0,0,6,8,6,13,0,0,0,0,718,31,749
14,VILLA UNION,1503,50,0,116,0,0,1,3,2,3,0,0,0,0,175,6,181
14,VILLA UNION,1504,15,0,63,0,0,0,1,0,0,0,0,0,0,79,3,82
14,VILLA UNION,1505,55,0,192,0,0,4,2,2,1,0,0,0,0,256,7,263
14,ZARAGOZA,1506,523,0,281,0,0,28,10,7,3,0,0,0,0,852,32,884
14,ZARAGOZA,1507,325,0,347,0,0,20,6,4,3,0,0,0,0,705,13,718
14,ZARAGOZA,1508,360,0,327,0,0,22,16,3,5,0,0,0,0,733,21,754
14,ZARAGOZA,1509,254,0,193,0,0,28,4,4,1,0,0,0,0,484,18,502
14,ZARAGOZA,1510,271,0,248,0,0,15,9,6,2,0,0,0,0,551,17,568
14,ZARAGOZA,1511,233,0,304,0,0,18,4,2,0,0,0,0,0,561,19,580
14,ZARAGOZA,1512,244,0,268,0,0,32,9,6,2,0,0,0,0,561,17,578
14,ZARAGOZA,1513,284,0,350,0,0,31,13,4,4,0,0,0,0,686,21,707
14,ZARAGOZA,1515,57,0,126,0,0,2,7,2,0,0,0,0,0,194,6,200
14,ZARAGOZA,1516,113,0,175,0,0,7,3,1,4,0,0,0,0,303,11,314
14,ZARAGOZA,1517,29,0,91,0,0,2,4,1,0,0,0,0,0,127,9,136
14,ZARAGOZA,1518,29,0,56,0,0,5,1,0,0,0,0,0,0,91,3,94
14,ZARAGOZA,1520,206,0,134,0,0,13,6,2,3,0,0,0,0,364,10,374
7,TORREON,1521,230,0,0,0,137,2,6,7,0,4,0,1,0,387,14,401
7,TORREON,1522,130,0,0,0,200,4,2,1,0,1,0,1,0,339,8,347
7,TORREON,1523,301,0,0,0,170,7,10,3,1,1,0,0,0,493,14,507
7,TORREON,1524,206,0,0,0,117,3,8,0,8,1,1,0,0,344,14,358
7,TORREON,1525,155,0,0,0,187,6,7,5,1,1,0,0,1,363,12,375
7,TORREON,1526,285,0,0,0,285,1,7,10,0,1,0,1,1,591,16,607
7,TORREON,1527,149,0,0,0,261,1,4,2,2,5,0,0,2,426,9,435
7,TORREON,1528,223,0,0,0,260,5,3,8,5,3,2,2,2,513,13,526
7,TORREON,1529,254,0,0,0,269,7,6,5,1,4,0,0,1,547,7,554
7,TORREON,1530,229,0,0,0,370,6,4,5,1,2,1,1,0,619,9,628
7,TORREON,1531,130,0,0,0,294,5,4,4,3,3,1,3,2,449,4,453
7,TORREON,1532,158,0,0,0,267,7,8,4,0,4,0,1,1,450,9,459
7,TORREON,1533,155,0,0,0,291,4,5,0,3,3,0,0,1,462,13,475
7,TORREON,1534,182,0,0,0,275,3,0,4,0,2,0,0,2,468,10,478
7,TORREON,1535,193,0,0,0,298,1,5,3,3,2,0,0,2,507,6,513
7,TORREON,1536,133,0,0,0,200,6,1,1,3,1,1,1,1,348,2,350
7,TORREON,1537,192,0,0,0,319,3,3,3,1,4,0,0,2,527,13,540
7,TORREON,1538,173,0,0,0,245,7,3,3,4,6,0,2,0,443,9,452
7,TORREON,1539,66,0,0,0,132,1,1,1,0,0,1,0,0,202,2,204
7,TORREON,1540,234,0,0,0,361,6,6,3,0,3,1,3,1,618,9,627
7,TORREON,1541,108,0,0,0,177,5,1,1,0,4,1,1,0,298,14,312
7,TORREON,1542,121,0,0,0,211,0,2,5,2,0,0,0,0,341,3,344
7,TORREON,1543,165,0,0,0,244,8,5,1,0,3,0,3,0,429,8,437
7,TORREON,1544,98,0,0,0,120,1,2,2,1,0,0,2,1,227,1,228
7,TORREON,1545,145,0,0,0,172,4,3,1,0,2,1,1,1,330,4,334
7,TORREON,1546,94,0,0,0,213,5,9,3,2,3,0,4,0,333,6,339
7,TORREON,1547,206,0,0,0,280,6,5,4,2,8,1,3,0,515,12,527
16,PIEDRAS NEGRAS,1548,91,0,0,0,233,8,0,8,1,3,0,1,0,345,5,350
16,PIEDRAS NEGRAS,1549,75,0,0,0,126,3,2,5,0,1,1,1,0,214,5,219
16,PIEDRAS NEGRAS,1550,83,0,0,0,219,6,0,7,0,0,0,2,1,318,6,324
16,PIEDRAS NEGRAS,1551,53,0,0,0,119,4,0,4,0,2,0,2,0,184,7,191
16,PIEDRAS NEGRAS,1552,167,0,0,0,401,10,9,9,1,1,2,2,0,602,12,614
16,PIEDRAS NEGRAS,1553,140,0,0,0,326,4,1,17,0,3,1,5,0,497,9,506
16,PIEDRAS NEGRAS,1554,182,0,0,0,424,12,3,13,4,1,1,5,1,646,8,654
16,PIEDRAS NEGRAS,1555,166,0,0,0,403,6,8,28,5,0,3,2,1,622,19,641
16,PIEDRAS NEGRAS,1556,51,0,0,0,179,1,0,5,2,0,0,0,0,238,2,240
16,PIEDRAS NEGRAS,1557,90,0,0,0,207,5,6,15,0,0,0,1,0,324,7,331
16,PIEDRAS NEGRAS,1558,69,0,0,0,169,6,3,6,1,1,2,0,0,257,5,262
16,PIEDRAS NEGRAS,1559,99,0,0,0,366,7,5,13,0,1,2,2,1,496,8,504
16,PIEDRAS NEGRAS,1560,150,0,0,0,335,5,6,12,0,4,0,1,0,513,10,523
16,PIEDRAS NEGRAS,1561,135,0,0,0,338,7,4,14,3,3,0,0,3,507,8,515
16,PIEDRAS NEGRAS,1562,82,0,0,0,280,3,0,12,1,0,1,1,0,380,4,384
16,PIEDRAS NEGRAS,1563,104,0,0,0,305,3,3,13,2,2,2,1,1,436,4,440
16,PIEDRAS NEGRAS,1564,152,0,0,0,308,6,5,19,3,2,0,3,0,498,10,508
16,PIEDRAS NEGRAS,1565,122,0,0,0,327,1,6,20,0,1,1,3,2,483,9,492
16,PIEDRAS NEGRAS,1566,187,0,0,0,362,13,7,19,0,0,1,3,1,593,15,608
16,PIEDRAS NEGRAS,1567,190,0,0,0,388,7,2,17,9,2,0,0,0,615,13,628
12,CASTAÑOS,1568,151,0,232,0,0,9,13,4,28,0,0,0,0,437,6,443
12,CASTAÑOS,1569,132,0,207,0,0,14,4,4,20,0,0,0,0,381,24,405
12,CASTAÑOS,1570,150,0,265,0,0,17,8,4,8,0,0,0,0,452,16,468
7,TORREON,1571,52,0,0,0,75,5,0,3,0,0,0,1,2,138,1,139
7,TORREON,1572,78,0,0,0,234,4,4,3,3,2,2,0,1,331,6,337
7,TORREON,1573,125,0,0,0,94,0,2,2,0,1,0,1,0,225,8,233
7,TORREON,1574,99,0,0,0,163,2,0,7,1,3,0,2,0,277,5,282
7,TORREON,1575,119,0,0,0,114,1,5,3,3,7,0,2,12,266,5,271
7,TORREON,1576,132,0,0,0,165,5,7,2,4,9,0,2,1,327,4,331
7,TORREON,1577,145,0,0,0,197,7,6,2,2,4,3,0,42,408,11,419
7,TORREON,1578,86,0,0,0,162,1,2,1,0,0,0,1,1,254,10,264
7,TORREON,1579,152,0,0,0,162,3,2,0,1,3,0,4,0,327,12,339
7,TORREON,1580,36,0,0,0,67,0,2,0,0,1,0,0,0,106,3,109
7,TORREON,1581,80,0,0,0,190,9,5,4,2,3,0,0,0,293,6,299
7,TORREON,1582,53,0,0,0,140,1,5,2,0,1,0,0,1,203,5,208
7,TORREON,1583,162,0,0,0,292,5,5,2,1,3,0,0,0,470,4,474
7,TORREON,1584,86,0,0,0,245,2,2,1,1,1,1,0,3,342,4,346
7,TORREON,1585,105,0,0,0,128,0,4,0,0,0,0,0,0,237,5,242
7,TORREON,1586,93,0,0,0,199,3,2,0,0,0,0,0,0,297,4,301
7,TORREON,1587,80,0,0,0,151,1,0,0,1,0,0,1,0,234,12,246
7,TORREON,1588,47,0,0,0,126,1,1,0,0,0,0,0,0,175,6,181
7,TORREON,1589,75,0,0,0,115,1,1,1,3,0,1,0,0,197,7,204
7,TORREON,1590,92,0,0,0,172,3,3,5,0,0,1,0,0,276,5,281
7,TORREON,1591,100,0,0,0,215,1,4,0,1,0,0,0,0,321,2,323
7,TORREON,1592,96,0,0,0,175,0,1,1,0,0,0,0,0,273,5,278
7,TORREON,1593,81,0,0,0,276,4,7,2,0,0,0,8,4,382,6,388
7,TORREON,1594,28,0,0,0,107,0,2,1,0,0,0,1,0,139,5,144
7,TORREON,1595,86,0,0,0,143,3,6,0,1,1,0,11,0,251,8,259
7,TORREON,1596,36,0,0,0,166,0,0,0,0,0,2,10,0,214,1,215
7,TORREON,1597,60,0,0,0,249,2,3,2,1,1,0,0,0,318,12,330
7,TORREON,1598,111,0,0,0,234,2,2,1,0,2,0,0,0,352,6,358
7,TORREON,1599,37,0,0,0,293,2,1,2,0,0,1,3,0,339,6,345
7,TORREON,1600,36,0,0,0,143,5,0,1,0,0,1,4,1,191,3,194
7,TORREON,1601,20,0,0,0,107,0,0,0,0,0,0,0,0,127,7,134
7,TORREON,1602,27,0,0,0,244,2,2,2,0,0,0,0,0,277,4,281
7,TORREON,1603,18,0,0,0,209,0,0,0,2,0,0,0,0,229,7,236
7,TORREON,1604,35,0,0,0,296,0,0,1,0,0,0,0,1,333,10,343
7,TORREON,1605,59,0,0,0,180,2,2,1,1,0,0,1,0,246,8,254
7,TORREON,1606,26,0,0,0,173,1,1,2,0,0,0,0,0,203,6,209
7,TORREON,1607,40,0,0,0,104,0,0,0,0,0,0,0,0,144,2,146
7,TORREON,1608,25,0,0,0,133,3,2,1,0,0,0,1,0,165,4,169
7,TORREON,1609,16,0,0,0,117,0,0,0,1,0,0,1,0,135,2,137
7,TORREON,1610,15,0,0,0,89,0,1,1,1,0,0,0,0,107,5,112
